"KOMMNR","KOMMNAVN","KRETSNR","KRETSNAVN","PARTIKODE","VALGSTEMMER","FORHSTEMMER","SUM"
"0101","Halden","0000",,"A",3836,643,4479
"0101","Halden","0000",,"SV",465,70,535
"0101","Halden","0000",,"RØDT",148,27,175
"0101","Halden","0000",,"SP",583,51,634
"0101","Halden","0000",,"KRF",550,110,660
"0101","Halden","0000",,"V",697,108,805
"0101","Halden","0000",,"H",4339,520,4859
"0101","Halden","0000",,"FRP",979,206,1185
"0101","Halden","0000",,"DEMN",28,2,30
"0101","Halden","0000",,"MDG",346,47,393
"0101","Halden","0000",,"PP",145,46,191
"0101","Halden","0000",,"VV",161,18,179
"0104","Moss","0000",,"A",4089,1102,5191
"0104","Moss","0000",,"SV",417,107,524
"0104","Moss","0000",,"RØDT",413,83,496
"0104","Moss","0000",,"KRF",316,68,384
"0104","Moss","0000",,"V",561,84,645
"0104","Moss","0000",,"H",4573,962,5535
"0104","Moss","0000",,"FRP",1426,358,1784
"0104","Moss","0000",,"MDG",66,24,90
"0104","Moss","0000",,"PP",160,44,204
"0105","Sarpsborg","0000",,"A",9628,1493,11121
"0105","Sarpsborg","0000",,"SV",382,106,488
"0105","Sarpsborg","0000",,"RØDT",96,11,107
"0105","Sarpsborg","0000",,"SP",691,57,748
"0105","Sarpsborg","0000",,"KRF",1150,196,1346
"0105","Sarpsborg","0000",,"V",537,88,625
"0105","Sarpsborg","0000",,"H",4193,576,4769
"0105","Sarpsborg","0000",,"FRP",2794,436,3230
"0105","Sarpsborg","0000",,"DEMN",48,4,52
"0105","Sarpsborg","0000",,"KSP",43,6,49
"0105","Sarpsborg","0000",,"PP",478,96,574
"0106","Fredrikstad","0000",,"A",14951,2693,17644
"0106","Fredrikstad","0000",,"SV",868,212,1080
"0106","Fredrikstad","0000",,"RØDT",192,44,236
"0106","Fredrikstad","0000",,"SP",608,59,667
"0106","Fredrikstad","0000",,"KRF",1274,252,1526
"0106","Fredrikstad","0000",,"V",875,176,1051
"0106","Fredrikstad","0000",,"H",6111,1057,7168
"0106","Fredrikstad","0000",,"FRP",4148,824,4972
"0106","Fredrikstad","0000",,"KSP",48,8,56
"0106","Fredrikstad","0000",,"KYST",67,4,71
"0106","Fredrikstad","0000",,"PP",556,108,664
"0106","Fredrikstad","0000",,"BYMILJØ",465,113,578
"0106","Fredrikstad","0000",,"FS",124,15,139
"0111","Hvaler","0000",,"A",543,133,676
"0111","Hvaler","0000",,"SV",125,36,161
"0111","Hvaler","0000",,"SP",61,19,80
"0111","Hvaler","0000",,"V",103,19,122
"0111","Hvaler","0000",,"H",467,125,592
"0111","Hvaler","0000",,"FRP",619,151,770
"0118","Aremark","0000",,"A",171,32,203
"0118","Aremark","0000",,"SP",252,20,272
"0118","Aremark","0000",,"KRF",96,23,119
"0118","Aremark","0000",,"V",72,8,80
"0118","Aremark","0000",,"H",94,15,109
"0119","Marker","0000",,"A",737,147,884
"0119","Marker","0000",,"SP",367,55,422
"0119","Marker","0000",,"KRF",213,30,243
"0119","Marker","0000",,"H",231,23,254
"0119","Marker","0000",,"FRP",64,15,79
"0121","Rømskog","0000",,"A",100,20,120
"0121","Rømskog","0000",,"SP",105,33,138
"0121","Rømskog","0000",,"KRF",120,16,136
"0121","Rømskog","0000",,"FRP",27,11,38
"0122","Trøgstad","0000",,"A",522,115,637
"0122","Trøgstad","0000",,"SP",753,122,875
"0122","Trøgstad","0000",,"KRF",96,46,142
"0122","Trøgstad","0000",,"V",57,13,70
"0122","Trøgstad","0000",,"H",322,62,384
"0122","Trøgstad","0000",,"FRP",295,59,354
"0123","Spydeberg","0000",,"A",546,82,628
"0123","Spydeberg","0000",,"SV",59,14,73
"0123","Spydeberg","0000",,"SP",425,62,487
"0123","Spydeberg","0000",,"KRF",224,65,289
"0123","Spydeberg","0000",,"V",147,15,162
"0123","Spydeberg","0000",,"H",508,73,581
"0123","Spydeberg","0000",,"FRP",311,47,358
"0124","Askim","0000",,"A",1887,513,2400
"0124","Askim","0000",,"SV",159,44,203
"0124","Askim","0000",,"SP",234,42,276
"0124","Askim","0000",,"KRF",310,92,402
"0124","Askim","0000",,"V",181,41,222
"0124","Askim","0000",,"H",1759,322,2081
"0124","Askim","0000",,"FRP",570,186,756
"0124","Askim","0000",,"ASKIMP",246,48,294
"0125","Eidsberg","0000",,"A",819,197,1016
"0125","Eidsberg","0000",,"SV",96,37,133
"0125","Eidsberg","0000",,"SP",608,115,723
"0125","Eidsberg","0000",,"KRF",246,50,296
"0125","Eidsberg","0000",,"V",255,58,313
"0125","Eidsberg","0000",,"H",1829,339,2168
"0125","Eidsberg","0000",,"FRP",302,81,383
"0127","Skiptvet","0000",,"A",650,104,754
"0127","Skiptvet","0000",,"SP",293,34,327
"0127","Skiptvet","0000",,"KRF",117,25,142
"0127","Skiptvet","0000",,"H",240,40,280
"0127","Skiptvet","0000",,"FRP",119,15,134
"0128","Rakkestad","0000",,"A",745,102,847
"0128","Rakkestad","0000",,"SV",48,6,54
"0128","Rakkestad","0000",,"SP",802,94,896
"0128","Rakkestad","0000",,"KRF",414,67,481
"0128","Rakkestad","0000",,"V",505,45,550
"0128","Rakkestad","0000",,"H",246,53,299
"0128","Rakkestad","0000",,"FRP",284,41,325
"0135","Råde","0000",,"A",832,153,985
"0135","Råde","0000",,"SP",386,46,432
"0135","Råde","0000",,"KRF",263,45,308
"0135","Råde","0000",,"V",326,47,373
"0135","Råde","0000",,"H",736,85,821
"0135","Råde","0000",,"FRP",637,132,769
"0136","Rygge","0000",,"A",1802,392,2194
"0136","Rygge","0000",,"SV",258,65,323
"0136","Rygge","0000",,"SP",170,30,200
"0136","Rygge","0000",,"KRF",306,62,368
"0136","Rygge","0000",,"V",642,77,719
"0136","Rygge","0000",,"H",1624,321,1945
"0136","Rygge","0000",,"FRP",810,200,1010
"0136","Rygge","0000",,"MDG",31,8,39
"0136","Rygge","0000",,"PP",202,34,236
"0137","Våler","0000",,"A",307,50,357
"0137","Våler","0000",,"SV",56,7,63
"0137","Våler","0000",,"SP",511,53,564
"0137","Våler","0000",,"KRF",135,15,150
"0137","Våler","0000",,"V",44,3,47
"0137","Våler","0000",,"H",495,37,532
"0137","Våler","0000",,"FRP",369,37,406
"0138","Hobøl","0000",,"A",608,93,701
"0138","Hobøl","0000",,"SP",190,24,214
"0138","Hobøl","0000",,"KRF",121,19,140
"0138","Hobøl","0000",,"V",282,26,308
"0138","Hobøl","0000",,"H",391,38,429
"0138","Hobøl","0000",,"FRP",467,58,525
"0211","Vestby","0000",,"A",1945,403,2348
"0211","Vestby","0000",,"SV",312,48,360
"0211","Vestby","0000",,"RØDT",50,10,60
"0211","Vestby","0000",,"SP",381,64,445
"0211","Vestby","0000",,"KRF",188,34,222
"0211","Vestby","0000",,"V",398,60,458
"0211","Vestby","0000",,"H",2480,396,2876
"0211","Vestby","0000",,"FRP",535,152,687
"0211","Vestby","0000",,"MDG",55,14,69
"0213","Ski","0000",,"A",3707,878,4585
"0213","Ski","0000",,"SV",501,113,614
"0213","Ski","0000",,"RØDT",171,35,206
"0213","Ski","0000",,"SP",308,54,362
"0213","Ski","0000",,"KRF",399,90,489
"0213","Ski","0000",,"V",774,153,927
"0213","Ski","0000",,"H",4296,752,5048
"0213","Ski","0000",,"FRP",1257,270,1527
"0213","Ski","0000",,"MDG",139,24,163
"0213","Ski","0000",,"PP",239,79,318
"0214","Ås","0000",,"A",2051,405,2456
"0214","Ås","0000",,"SV",573,159,732
"0214","Ås","0000",,"SP",632,107,739
"0214","Ås","0000",,"KRF",250,66,316
"0214","Ås","0000",,"V",670,112,782
"0214","Ås","0000",,"H",1761,243,2004
"0214","Ås","0000",,"FRP",728,109,837
"0214","Ås","0000",,"MDG",166,31,197
"0215","Frogn","0000",,"A",1420,435,1855
"0215","Frogn","0000",,"SV",324,76,400
"0215","Frogn","0000",,"SP",238,41,279
"0215","Frogn","0000",,"KRF",409,136,545
"0215","Frogn","0000",,"V",1016,242,1258
"0215","Frogn","0000",,"H",1982,498,2480
"0215","Frogn","0000",,"FRP",519,148,667
"0215","Frogn","0000",,"PP",295,85,380
"0216","Nesodden","0000",,"A",1855,695,2550
"0216","Nesodden","0000",,"SV",1103,459,1562
"0216","Nesodden","0000",,"RØDT",408,127,535
"0216","Nesodden","0000",,"SP",40,18,58
"0216","Nesodden","0000",,"KRF",307,100,407
"0216","Nesodden","0000",,"V",467,112,579
"0216","Nesodden","0000",,"H",1881,624,2505
"0216","Nesodden","0000",,"FRP",414,151,565
"0216","Nesodden","0000",,"DEMN",16,8,24
"0216","Nesodden","0000",,"MDG",333,129,462
"0217","Oppegård","0000",,"A",2806,671,3477
"0217","Oppegård","0000",,"SV",527,119,646
"0217","Oppegård","0000",,"RØDT",66,15,81
"0217","Oppegård","0000",,"SP",61,19,80
"0217","Oppegård","0000",,"KRF",500,108,608
"0217","Oppegård","0000",,"V",903,133,1036
"0217","Oppegård","0000",,"H",5510,1151,6661
"0217","Oppegård","0000",,"FRP",826,224,1050
"0217","Oppegård","0000",,"MDG",105,17,122
"0219","Bærum","0000",,"A",9570,2905,12475
"0219","Bærum","0000",,"SV",1527,471,1998
"0219","Bærum","0000",,"RØDT",511,151,662
"0219","Bærum","0000",,"SP",381,101,482
"0219","Bærum","0000",,"KRF",1216,336,1552
"0219","Bærum","0000",,"V",4403,977,5380
"0219","Bærum","0000",,"H",23564,6732,30296
"0219","Bærum","0000",,"FRP",3472,1127,4599
"0219","Bærum","0000",,"MDG",550,149,699
"0219","Bærum","0000",,"PP",680,274,954
"0220","Asker","0000",,"A",4302,1429,5731
"0220","Asker","0000",,"SV",628,200,828
"0220","Asker","0000",,"RØDT",186,61,247
"0220","Asker","0000",,"SP",252,55,307
"0220","Asker","0000",,"KRF",614,175,789
"0220","Asker","0000",,"V",1667,357,2024
"0220","Asker","0000",,"H",11665,3236,14901
"0220","Asker","0000",,"FRP",1678,622,2300
"0220","Asker","0000",,"PP",346,182,528
"0220","Asker","0000",,"AGV",822,219,1041
"0221","Aurskog-Høland","0000",,"A",2251,424,2675
"0221","Aurskog-Høland","0000",,"SV",148,26,174
"0221","Aurskog-Høland","0000",,"SP",813,108,921
"0221","Aurskog-Høland","0000",,"KRF",469,91,560
"0221","Aurskog-Høland","0000",,"V",108,18,126
"0221","Aurskog-Høland","0000",,"H",1079,165,1244
"0221","Aurskog-Høland","0000",,"FRP",1300,206,1506
"0226","Sørum","0000",,"A",2677,456,3133
"0226","Sørum","0000",,"SV",248,40,288
"0226","Sørum","0000",,"SP",541,59,600
"0226","Sørum","0000",,"KRF",263,56,319
"0226","Sørum","0000",,"V",245,38,283
"0226","Sørum","0000",,"H",1980,252,2232
"0226","Sørum","0000",,"FRP",787,130,917
"0227","Fet","0000",,"A",1767,286,2053
"0227","Fet","0000",,"SV",154,26,180
"0227","Fet","0000",,"SP",347,59,406
"0227","Fet","0000",,"V",296,24,320
"0227","Fet","0000",,"H",1148,181,1329
"0227","Fet","0000",,"FRP",717,118,835
"0227","Fet","0000",,"MDG",84,19,103
"0228","Rælingen","0000",,"A",3257,838,4095
"0228","Rælingen","0000",,"SV",176,45,221
"0228","Rælingen","0000",,"RØDT",41,8,49
"0228","Rælingen","0000",,"SP",92,22,114
"0228","Rælingen","0000",,"KRF",193,55,248
"0228","Rælingen","0000",,"V",232,28,260
"0228","Rælingen","0000",,"H",1390,304,1694
"0228","Rælingen","0000",,"FRP",643,156,799
"0229","Enebakk","0000",,"A",1014,220,1234
"0229","Enebakk","0000",,"SV",221,35,256
"0229","Enebakk","0000",,"SP",475,56,531
"0229","Enebakk","0000",,"KRF",169,32,201
"0229","Enebakk","0000",,"V",134,20,154
"0229","Enebakk","0000",,"H",1173,152,1325
"0229","Enebakk","0000",,"FRP",974,116,1090
"0230","Lørenskog","0000",,"A",5927,1388,7315
"0230","Lørenskog","0000",,"SV",420,103,523
"0230","Lørenskog","0000",,"RØDT",164,28,192
"0230","Lørenskog","0000",,"SP",136,21,157
"0230","Lørenskog","0000",,"KRF",417,100,517
"0230","Lørenskog","0000",,"V",662,89,751
"0230","Lørenskog","0000",,"H",4210,676,4886
"0230","Lørenskog","0000",,"FRP",1559,335,1894
"0230","Lørenskog","0000",,"LVH",330,50,380
"0231","Skedsmo","0000",,"A",7331,1930,9261
"0231","Skedsmo","0000",,"SV",636,178,814
"0231","Skedsmo","0000",,"RØDT",154,48,202
"0231","Skedsmo","0000",,"SP",308,63,371
"0231","Skedsmo","0000",,"KRF",443,128,571
"0231","Skedsmo","0000",,"V",676,154,830
"0231","Skedsmo","0000",,"H",5801,1246,7047
"0231","Skedsmo","0000",,"FRP",2109,623,2732
"0231","Skedsmo","0000",,"MDG",104,23,127
"0231","Skedsmo","0000",,"PP",257,111,368
"0231","Skedsmo","0000",,"FRBB",657,209,866
"0233","Nittedal","0000",,"A",3006,568,3574
"0233","Nittedal","0000",,"SV",234,51,285
"0233","Nittedal","0000",,"RØDT",91,22,113
"0233","Nittedal","0000",,"SP",298,58,356
"0233","Nittedal","0000",,"KRF",197,57,254
"0233","Nittedal","0000",,"V",876,131,1007
"0233","Nittedal","0000",,"H",2876,485,3361
"0233","Nittedal","0000",,"FRP",1214,237,1451
"0234","Gjerdrum","0000",,"A",815,174,989
"0234","Gjerdrum","0000",,"SV",54,23,77
"0234","Gjerdrum","0000",,"SP",234,30,264
"0234","Gjerdrum","0000",,"KRF",120,34,154
"0234","Gjerdrum","0000",,"V",293,44,337
"0234","Gjerdrum","0000",,"H",741,109,850
"0234","Gjerdrum","0000",,"FRP",238,49,287
"0235","Ullensaker","0000",,"A",3478,816,4294
"0235","Ullensaker","0000",,"SV",222,77,299
"0235","Ullensaker","0000",,"RØDT",76,23,99
"0235","Ullensaker","0000",,"SP",556,65,621
"0235","Ullensaker","0000",,"KRF",265,53,318
"0235","Ullensaker","0000",,"V",355,64,419
"0235","Ullensaker","0000",,"H",2084,380,2464
"0235","Ullensaker","0000",,"FRP",4029,845,4874
"0235","Ullensaker","0000",,"PP",115,41,156
"0236","Nes","0000",,"A",2398,698,3096
"0236","Nes","0000",,"SV",236,50,286
"0236","Nes","0000",,"RØDT",70,10,80
"0236","Nes","0000",,"SP",707,146,853
"0236","Nes","0000",,"KRF",275,53,328
"0236","Nes","0000",,"V",444,89,533
"0236","Nes","0000",,"H",1539,281,1820
"0236","Nes","0000",,"FRP",1461,313,1774
"0237","Eidsvoll","0000",,"A",2933,506,3439
"0237","Eidsvoll","0000",,"SV",355,83,438
"0237","Eidsvoll","0000",,"RØDT",46,17,63
"0237","Eidsvoll","0000",,"SP",656,73,729
"0237","Eidsvoll","0000",,"KRF",300,49,349
"0237","Eidsvoll","0000",,"V",265,41,306
"0237","Eidsvoll","0000",,"H",2131,317,2448
"0237","Eidsvoll","0000",,"FRP",1224,192,1416
"0237","Eidsvoll","0000",,"PP",153,22,175
"0237","Eidsvoll","0000",,"EDP",174,21,195
"0238","Nannestad","0000",,"A",1407,313,1720
"0238","Nannestad","0000",,"SV",117,32,149
"0238","Nannestad","0000",,"SP",309,51,360
"0238","Nannestad","0000",,"KRF",170,43,213
"0238","Nannestad","0000",,"V",427,49,476
"0238","Nannestad","0000",,"H",952,157,1109
"0238","Nannestad","0000",,"FRP",834,180,1014
"0239","Hurdal","0000",,"A",250,71,321
"0239","Hurdal","0000",,"SV",27,16,43
"0239","Hurdal","0000",,"SP",71,17,88
"0239","Hurdal","0000",,"KRF",74,44,118
"0239","Hurdal","0000",,"V",361,87,448
"0239","Hurdal","0000",,"H",84,35,119
"0239","Hurdal","0000",,"FRP",187,40,227
"0301","Oslo","FORH","Forhånd ikke kretsfordelt","A",0,534,534
"0301","Oslo","FORH","Forhånd ikke kretsfordelt","SV",0,102,102
"0301","Oslo","FORH","Forhånd ikke kretsfordelt","RØDT",0,60,60
"0301","Oslo","FORH","Forhånd ikke kretsfordelt","SP",0,11,11
"0301","Oslo","FORH","Forhånd ikke kretsfordelt","KRF",0,44,44
"0301","Oslo","FORH","Forhånd ikke kretsfordelt","V",0,155,155
"0301","Oslo","FORH","Forhånd ikke kretsfordelt","H",0,476,476
"0301","Oslo","FORH","Forhånd ikke kretsfordelt","FRP",0,115,115
"0301","Oslo","FORH","Forhånd ikke kretsfordelt","DEMN",0,4,4
"0301","Oslo","FORH","Forhånd ikke kretsfordelt","DLF",0,2,2
"0301","Oslo","FORH","Forhånd ikke kretsfordelt","KYST",0,2,2
"0301","Oslo","FORH","Forhånd ikke kretsfordelt","MDG",0,47,47
"0301","Oslo","FORH","Forhånd ikke kretsfordelt","NKP",0,2,2
"0301","Oslo","FORH","Forhånd ikke kretsfordelt","PP",0,11,11
"0301","Oslo","FREM","Fremmede ikke kretsfordelt","A",6898,0,6898
"0301","Oslo","FREM","Fremmede ikke kretsfordelt","SV",1601,0,1601
"0301","Oslo","FREM","Fremmede ikke kretsfordelt","RØDT",960,0,960
"0301","Oslo","FREM","Fremmede ikke kretsfordelt","SP",98,0,98
"0301","Oslo","FREM","Fremmede ikke kretsfordelt","KRF",431,0,431
"0301","Oslo","FREM","Fremmede ikke kretsfordelt","V",2315,0,2315
"0301","Oslo","FREM","Fremmede ikke kretsfordelt","H",6854,0,6854
"0301","Oslo","FREM","Fremmede ikke kretsfordelt","FRP",1059,0,1059
"0301","Oslo","FREM","Fremmede ikke kretsfordelt","DEMN",23,0,23
"0301","Oslo","FREM","Fremmede ikke kretsfordelt","DLF",27,0,27
"0301","Oslo","FREM","Fremmede ikke kretsfordelt","KSP",15,0,15
"0301","Oslo","FREM","Fremmede ikke kretsfordelt","KYST",5,0,5
"0301","Oslo","FREM","Fremmede ikke kretsfordelt","MDG",900,0,900
"0301","Oslo","FREM","Fremmede ikke kretsfordelt","NKP",16,0,16
"0301","Oslo","FREM","Fremmede ikke kretsfordelt","PP",44,0,44
"0301","Oslo","VALG","Valgting ikke kretsfordelt","A",13,0,13
"0301","Oslo","VALG","Valgting ikke kretsfordelt","SV",2,0,2
"0301","Oslo","VALG","Valgting ikke kretsfordelt","RØDT",1,0,1
"0301","Oslo","VALG","Valgting ikke kretsfordelt","KRF",2,0,2
"0301","Oslo","VALG","Valgting ikke kretsfordelt","V",2,0,2
"0301","Oslo","VALG","Valgting ikke kretsfordelt","H",20,0,20
"0301","Oslo","VALG","Valgting ikke kretsfordelt","FRP",6,0,6
"0301","Oslo","VALG","Valgting ikke kretsfordelt","DLF",1,0,1
"0301","Oslo","VALG","Valgting ikke kretsfordelt","PP",1,0,1
"0301","Oslo","0101","Vahl skole","A",489,630,1119
"0301","Oslo","0101","Vahl skole","SV",156,121,277
"0301","Oslo","0101","Vahl skole","RØDT",116,111,227
"0301","Oslo","0101","Vahl skole","SP",14,36,50
"0301","Oslo","0101","Vahl skole","KRF",15,8,23
"0301","Oslo","0101","Vahl skole","V",149,97,246
"0301","Oslo","0101","Vahl skole","H",219,171,390
"0301","Oslo","0101","Vahl skole","FRP",54,72,126
"0301","Oslo","0101","Vahl skole","DEMN",1,2,3
"0301","Oslo","0101","Vahl skole","DLF",2,2,4
"0301","Oslo","0101","Vahl skole","KSP",2,0,2
"0301","Oslo","0101","Vahl skole","KYST",0,1,1
"0301","Oslo","0101","Vahl skole","MDG",66,47,113
"0301","Oslo","0101","Vahl skole","NKP",2,0,2
"0301","Oslo","0101","Vahl skole","PP",2,3,5
"0301","Oslo","0102","Tøyen skole","A",880,596,1476
"0301","Oslo","0102","Tøyen skole","SV",250,111,361
"0301","Oslo","0102","Tøyen skole","RØDT",190,110,300
"0301","Oslo","0102","Tøyen skole","SP",19,13,32
"0301","Oslo","0102","Tøyen skole","KRF",30,16,46
"0301","Oslo","0102","Tøyen skole","V",209,91,300
"0301","Oslo","0102","Tøyen skole","H",343,141,484
"0301","Oslo","0102","Tøyen skole","FRP",105,58,163
"0301","Oslo","0102","Tøyen skole","DEMN",0,2,2
"0301","Oslo","0102","Tøyen skole","DLF",3,1,4
"0301","Oslo","0102","Tøyen skole","KSP",1,0,1
"0301","Oslo","0102","Tøyen skole","KYST",0,1,1
"0301","Oslo","0102","Tøyen skole","MDG",151,56,207
"0301","Oslo","0102","Tøyen skole","NKP",3,2,5
"0301","Oslo","0102","Tøyen skole","PP",2,4,6
"0301","Oslo","0103","Kampen skole","A",715,253,968
"0301","Oslo","0103","Kampen skole","SV",235,64,299
"0301","Oslo","0103","Kampen skole","RØDT",158,56,214
"0301","Oslo","0103","Kampen skole","SP",7,4,11
"0301","Oslo","0103","Kampen skole","KRF",19,6,25
"0301","Oslo","0103","Kampen skole","V",177,52,229
"0301","Oslo","0103","Kampen skole","H",352,73,425
"0301","Oslo","0103","Kampen skole","FRP",91,29,120
"0301","Oslo","0103","Kampen skole","DEMN",2,0,2
"0301","Oslo","0103","Kampen skole","DLF",4,0,4
"0301","Oslo","0103","Kampen skole","KYST",2,0,2
"0301","Oslo","0103","Kampen skole","MDG",98,31,129
"0301","Oslo","0103","Kampen skole","NKP",1,0,1
"0301","Oslo","0103","Kampen skole","PP",3,1,4
"0301","Oslo","0104","Gamlebyen skole","A",594,617,1211
"0301","Oslo","0104","Gamlebyen skole","SV",209,154,363
"0301","Oslo","0104","Gamlebyen skole","RØDT",217,131,348
"0301","Oslo","0104","Gamlebyen skole","SP",6,22,28
"0301","Oslo","0104","Gamlebyen skole","KRF",25,24,49
"0301","Oslo","0104","Gamlebyen skole","V",313,155,468
"0301","Oslo","0104","Gamlebyen skole","H",450,374,824
"0301","Oslo","0104","Gamlebyen skole","FRP",102,113,215
"0301","Oslo","0104","Gamlebyen skole","DLF",6,3,9
"0301","Oslo","0104","Gamlebyen skole","KSP",2,2,4
"0301","Oslo","0104","Gamlebyen skole","MDG",146,77,223
"0301","Oslo","0104","Gamlebyen skole","NKP",0,2,2
"0301","Oslo","0104","Gamlebyen skole","PP",2,3,5
"0301","Oslo","0105","Jordal skole","A",369,164,533
"0301","Oslo","0105","Jordal skole","SV",145,55,200
"0301","Oslo","0105","Jordal skole","RØDT",109,39,148
"0301","Oslo","0105","Jordal skole","SP",2,1,3
"0301","Oslo","0105","Jordal skole","KRF",12,12,24
"0301","Oslo","0105","Jordal skole","V",111,33,144
"0301","Oslo","0105","Jordal skole","H",182,53,235
"0301","Oslo","0105","Jordal skole","FRP",54,20,74
"0301","Oslo","0105","Jordal skole","DEMN",1,1,2
"0301","Oslo","0105","Jordal skole","DLF",2,0,2
"0301","Oslo","0105","Jordal skole","KYST",0,1,1
"0301","Oslo","0105","Jordal skole","MDG",58,16,74
"0301","Oslo","0105","Jordal skole","PP",4,2,6
"0301","Oslo","0106","Vålerenga skole","A",560,270,830
"0301","Oslo","0106","Vålerenga skole","SV",162,62,224
"0301","Oslo","0106","Vålerenga skole","RØDT",133,48,181
"0301","Oslo","0106","Vålerenga skole","SP",9,8,17
"0301","Oslo","0106","Vålerenga skole","KRF",12,13,25
"0301","Oslo","0106","Vålerenga skole","V",169,49,218
"0301","Oslo","0106","Vålerenga skole","H",311,133,444
"0301","Oslo","0106","Vålerenga skole","FRP",91,27,118
"0301","Oslo","0106","Vålerenga skole","DEMN",2,0,2
"0301","Oslo","0106","Vålerenga skole","DLF",3,0,3
"0301","Oslo","0106","Vålerenga skole","KYST",1,1,2
"0301","Oslo","0106","Vålerenga skole","MDG",51,20,71
"0301","Oslo","0106","Vålerenga skole","PP",3,0,3
"0301","Oslo","0107","Etterstad videregående skole","A",731,248,979
"0301","Oslo","0107","Etterstad videregående skole","SV",133,40,173
"0301","Oslo","0107","Etterstad videregående skole","RØDT",83,36,119
"0301","Oslo","0107","Etterstad videregående skole","SP",8,4,12
"0301","Oslo","0107","Etterstad videregående skole","KRF",24,7,31
"0301","Oslo","0107","Etterstad videregående skole","V",130,27,157
"0301","Oslo","0107","Etterstad videregående skole","H",458,123,581
"0301","Oslo","0107","Etterstad videregående skole","FRP",115,43,158
"0301","Oslo","0107","Etterstad videregående skole","DEMN",1,0,1
"0301","Oslo","0107","Etterstad videregående skole","DLF",1,1,2
"0301","Oslo","0107","Etterstad videregående skole","KSP",1,0,1
"0301","Oslo","0107","Etterstad videregående skole","KYST",2,0,2
"0301","Oslo","0107","Etterstad videregående skole","MDG",51,14,65
"0301","Oslo","0107","Etterstad videregående skole","NKP",1,0,1
"0301","Oslo","0107","Etterstad videregående skole","PP",4,2,6
"0301","Oslo","0108","Fyrstikkalléen skole","A",441,231,672
"0301","Oslo","0108","Fyrstikkalléen skole","SV",77,44,121
"0301","Oslo","0108","Fyrstikkalléen skole","RØDT",48,22,70
"0301","Oslo","0108","Fyrstikkalléen skole","SP",4,4,8
"0301","Oslo","0108","Fyrstikkalléen skole","KRF",27,17,44
"0301","Oslo","0108","Fyrstikkalléen skole","V",96,34,130
"0301","Oslo","0108","Fyrstikkalléen skole","H",312,100,412
"0301","Oslo","0108","Fyrstikkalléen skole","FRP",78,40,118
"0301","Oslo","0108","Fyrstikkalléen skole","KSP",1,3,4
"0301","Oslo","0108","Fyrstikkalléen skole","KYST",1,0,1
"0301","Oslo","0108","Fyrstikkalléen skole","MDG",40,12,52
"0301","Oslo","0108","Fyrstikkalléen skole","NKP",1,2,3
"0301","Oslo","0108","Fyrstikkalléen skole","PP",1,2,3
"0301","Oslo","0201","Hasle skole","A",894,241,1135
"0301","Oslo","0201","Hasle skole","SV",292,71,363
"0301","Oslo","0201","Hasle skole","RØDT",104,28,132
"0301","Oslo","0201","Hasle skole","SP",8,4,12
"0301","Oslo","0201","Hasle skole","KRF",49,13,62
"0301","Oslo","0201","Hasle skole","V",199,42,241
"0301","Oslo","0201","Hasle skole","H",504,127,631
"0301","Oslo","0201","Hasle skole","FRP",106,26,132
"0301","Oslo","0201","Hasle skole","DEMN",3,0,3
"0301","Oslo","0201","Hasle skole","DLF",3,0,3
"0301","Oslo","0201","Hasle skole","KSP",1,2,3
"0301","Oslo","0201","Hasle skole","KYST",1,0,1
"0301","Oslo","0201","Hasle skole","MDG",66,15,81
"0301","Oslo","0201","Hasle skole","NKP",2,0,2
"0301","Oslo","0201","Hasle skole","PP",6,1,7
"0301","Oslo","0202","Sinsen skole","A",1142,576,1718
"0301","Oslo","0202","Sinsen skole","SV",226,147,373
"0301","Oslo","0202","Sinsen skole","RØDT",133,78,211
"0301","Oslo","0202","Sinsen skole","SP",21,18,39
"0301","Oslo","0202","Sinsen skole","KRF",118,67,185
"0301","Oslo","0202","Sinsen skole","V",310,131,441
"0301","Oslo","0202","Sinsen skole","H",882,345,1227
"0301","Oslo","0202","Sinsen skole","FRP",184,88,272
"0301","Oslo","0202","Sinsen skole","DEMN",2,3,5
"0301","Oslo","0202","Sinsen skole","DLF",1,2,3
"0301","Oslo","0202","Sinsen skole","KSP",4,1,5
"0301","Oslo","0202","Sinsen skole","KYST",0,2,2
"0301","Oslo","0202","Sinsen skole","MDG",100,44,144
"0301","Oslo","0202","Sinsen skole","NKP",4,3,7
"0301","Oslo","0202","Sinsen skole","PP",7,7,14
"0301","Oslo","0203","Sofienberg videregående skole","A",1278,609,1887
"0301","Oslo","0203","Sofienberg videregående skole","SV",480,199,679
"0301","Oslo","0203","Sofienberg videregående skole","RØDT",321,119,440
"0301","Oslo","0203","Sofienberg videregående skole","SP",28,9,37
"0301","Oslo","0203","Sofienberg videregående skole","KRF",60,30,90
"0301","Oslo","0203","Sofienberg videregående skole","V",395,134,529
"0301","Oslo","0203","Sofienberg videregående skole","H",684,332,1016
"0301","Oslo","0203","Sofienberg videregående skole","FRP",147,76,223
"0301","Oslo","0203","Sofienberg videregående skole","DEMN",4,1,5
"0301","Oslo","0203","Sofienberg videregående skole","DLF",1,1,2
"0301","Oslo","0203","Sofienberg videregående skole","KSP",2,2,4
"0301","Oslo","0203","Sofienberg videregående skole","KYST",2,1,3
"0301","Oslo","0203","Sofienberg videregående skole","MDG",226,79,305
"0301","Oslo","0203","Sofienberg videregående skole","NKP",5,0,5
"0301","Oslo","0203","Sofienberg videregående skole","PP",11,8,19
"0301","Oslo","0204","Grünerløkka skole","A",563,320,883
"0301","Oslo","0204","Grünerløkka skole","SV",225,74,299
"0301","Oslo","0204","Grünerløkka skole","RØDT",124,56,180
"0301","Oslo","0204","Grünerløkka skole","SP",11,6,17
"0301","Oslo","0204","Grünerløkka skole","KRF",17,12,29
"0301","Oslo","0204","Grünerløkka skole","V",243,69,312
"0301","Oslo","0204","Grünerløkka skole","H",398,158,556
"0301","Oslo","0204","Grünerløkka skole","FRP",77,34,111
"0301","Oslo","0204","Grünerløkka skole","DEMN",2,0,2
"0301","Oslo","0204","Grünerløkka skole","DLF",1,0,1
"0301","Oslo","0204","Grünerløkka skole","MDG",90,23,113
"0301","Oslo","0204","Grünerløkka skole","NKP",1,2,3
"0301","Oslo","0204","Grünerløkka skole","PP",7,3,10
"0301","Oslo","0205","Foss videregående skole","A",579,306,885
"0301","Oslo","0205","Foss videregående skole","SV",217,107,324
"0301","Oslo","0205","Foss videregående skole","RØDT",146,54,200
"0301","Oslo","0205","Foss videregående skole","SP",17,1,18
"0301","Oslo","0205","Foss videregående skole","KRF",20,18,38
"0301","Oslo","0205","Foss videregående skole","V",262,100,362
"0301","Oslo","0205","Foss videregående skole","H",523,245,768
"0301","Oslo","0205","Foss videregående skole","FRP",55,48,103
"0301","Oslo","0205","Foss videregående skole","DEMN",2,1,3
"0301","Oslo","0205","Foss videregående skole","DLF",2,2,4
"0301","Oslo","0205","Foss videregående skole","KSP",0,1,1
"0301","Oslo","0205","Foss videregående skole","KYST",1,1,2
"0301","Oslo","0205","Foss videregående skole","MDG",109,44,153
"0301","Oslo","0205","Foss videregående skole","NKP",2,1,3
"0301","Oslo","0205","Foss videregående skole","PP",4,0,4
"0301","Oslo","0206","Anker hotell","A",646,595,1241
"0301","Oslo","0206","Anker hotell","SV",184,155,339
"0301","Oslo","0206","Anker hotell","RØDT",148,112,260
"0301","Oslo","0206","Anker hotell","SP",6,12,18
"0301","Oslo","0206","Anker hotell","KRF",21,30,51
"0301","Oslo","0206","Anker hotell","V",253,150,403
"0301","Oslo","0206","Anker hotell","H",403,300,703
"0301","Oslo","0206","Anker hotell","FRP",86,105,191
"0301","Oslo","0206","Anker hotell","DEMN",1,0,1
"0301","Oslo","0206","Anker hotell","DLF",2,2,4
"0301","Oslo","0206","Anker hotell","KSP",1,1,2
"0301","Oslo","0206","Anker hotell","KYST",1,1,2
"0301","Oslo","0206","Anker hotell","MDG",130,83,213
"0301","Oslo","0206","Anker hotell","NKP",1,2,3
"0301","Oslo","0206","Anker hotell","PP",3,7,10
"0301","Oslo","0301","Sagene samfunnshus","A",714,420,1134
"0301","Oslo","0301","Sagene samfunnshus","SV",196,95,291
"0301","Oslo","0301","Sagene samfunnshus","RØDT",128,71,199
"0301","Oslo","0301","Sagene samfunnshus","SP",14,10,24
"0301","Oslo","0301","Sagene samfunnshus","KRF",57,33,90
"0301","Oslo","0301","Sagene samfunnshus","V",282,93,375
"0301","Oslo","0301","Sagene samfunnshus","H",608,272,880
"0301","Oslo","0301","Sagene samfunnshus","FRP",87,49,136
"0301","Oslo","0301","Sagene samfunnshus","DEMN",2,1,3
"0301","Oslo","0301","Sagene samfunnshus","KYST",0,1,1
"0301","Oslo","0301","Sagene samfunnshus","MDG",91,31,122
"0301","Oslo","0301","Sagene samfunnshus","NKP",2,1,3
"0301","Oslo","0301","Sagene samfunnshus","PP",8,4,12
"0301","Oslo","0302","Bjølsen skole","A",658,337,995
"0301","Oslo","0302","Bjølsen skole","SV",177,73,250
"0301","Oslo","0302","Bjølsen skole","RØDT",80,44,124
"0301","Oslo","0302","Bjølsen skole","SP",13,6,19
"0301","Oslo","0302","Bjølsen skole","KRF",44,32,76
"0301","Oslo","0302","Bjølsen skole","V",261,101,362
"0301","Oslo","0302","Bjølsen skole","H",454,189,643
"0301","Oslo","0302","Bjølsen skole","FRP",79,32,111
"0301","Oslo","0302","Bjølsen skole","DEMN",1,1,2
"0301","Oslo","0302","Bjølsen skole","DLF",3,3,6
"0301","Oslo","0302","Bjølsen skole","KSP",0,1,1
"0301","Oslo","0302","Bjølsen skole","KYST",1,0,1
"0301","Oslo","0302","Bjølsen skole","MDG",82,25,107
"0301","Oslo","0302","Bjølsen skole","NKP",1,1,2
"0301","Oslo","0302","Bjølsen skole","PP",6,3,9
"0301","Oslo","0303","Deichmanske bibliotek filial Torshov","A",527,537,1064
"0301","Oslo","0303","Deichmanske bibliotek filial Torshov","SV",130,79,209
"0301","Oslo","0303","Deichmanske bibliotek filial Torshov","RØDT",74,51,125
"0301","Oslo","0303","Deichmanske bibliotek filial Torshov","SP",8,8,16
"0301","Oslo","0303","Deichmanske bibliotek filial Torshov","KRF",36,28,64
"0301","Oslo","0303","Deichmanske bibliotek filial Torshov","V",221,89,310
"0301","Oslo","0303","Deichmanske bibliotek filial Torshov","H",414,229,643
"0301","Oslo","0303","Deichmanske bibliotek filial Torshov","FRP",66,67,133
"0301","Oslo","0303","Deichmanske bibliotek filial Torshov","DEMN",2,0,2
"0301","Oslo","0303","Deichmanske bibliotek filial Torshov","DLF",1,1,2
"0301","Oslo","0303","Deichmanske bibliotek filial Torshov","KYST",1,0,1
"0301","Oslo","0303","Deichmanske bibliotek filial Torshov","MDG",42,32,74
"0301","Oslo","0303","Deichmanske bibliotek filial Torshov","NKP",1,0,1
"0301","Oslo","0303","Deichmanske bibliotek filial Torshov","PP",4,4,8
"0301","Oslo","0304","Lilleborg skole","A",760,384,1144
"0301","Oslo","0304","Lilleborg skole","SV",250,111,361
"0301","Oslo","0304","Lilleborg skole","RØDT",127,64,191
"0301","Oslo","0304","Lilleborg skole","SP",9,9,18
"0301","Oslo","0304","Lilleborg skole","KRF",45,13,58
"0301","Oslo","0304","Lilleborg skole","V",269,111,380
"0301","Oslo","0304","Lilleborg skole","H",443,161,604
"0301","Oslo","0304","Lilleborg skole","FRP",70,39,109
"0301","Oslo","0304","Lilleborg skole","DEMN",3,1,4
"0301","Oslo","0304","Lilleborg skole","DLF",1,1,2
"0301","Oslo","0304","Lilleborg skole","KSP",0,1,1
"0301","Oslo","0304","Lilleborg skole","KYST",1,0,1
"0301","Oslo","0304","Lilleborg skole","MDG",100,36,136
"0301","Oslo","0304","Lilleborg skole","NKP",3,2,5
"0301","Oslo","0304","Lilleborg skole","PP",4,5,9
"0301","Oslo","0305","Sagene festivitetshus","A",580,400,980
"0301","Oslo","0305","Sagene festivitetshus","SV",161,135,296
"0301","Oslo","0305","Sagene festivitetshus","RØDT",105,79,184
"0301","Oslo","0305","Sagene festivitetshus","SP",7,11,18
"0301","Oslo","0305","Sagene festivitetshus","KRF",35,24,59
"0301","Oslo","0305","Sagene festivitetshus","V",263,132,395
"0301","Oslo","0305","Sagene festivitetshus","H",533,300,833
"0301","Oslo","0305","Sagene festivitetshus","FRP",56,55,111
"0301","Oslo","0305","Sagene festivitetshus","DLF",3,1,4
"0301","Oslo","0305","Sagene festivitetshus","KSP",1,2,3
"0301","Oslo","0305","Sagene festivitetshus","MDG",83,44,127
"0301","Oslo","0305","Sagene festivitetshus","NKP",1,0,1
"0301","Oslo","0305","Sagene festivitetshus","PP",6,1,7
"0301","Oslo","0306","Grefsenveien 28 selskapslokale","A",598,423,1021
"0301","Oslo","0306","Grefsenveien 28 selskapslokale","SV",128,83,211
"0301","Oslo","0306","Grefsenveien 28 selskapslokale","RØDT",76,40,116
"0301","Oslo","0306","Grefsenveien 28 selskapslokale","SP",8,11,19
"0301","Oslo","0306","Grefsenveien 28 selskapslokale","KRF",72,36,108
"0301","Oslo","0306","Grefsenveien 28 selskapslokale","V",196,95,291
"0301","Oslo","0306","Grefsenveien 28 selskapslokale","H",558,279,837
"0301","Oslo","0306","Grefsenveien 28 selskapslokale","FRP",86,55,141
"0301","Oslo","0306","Grefsenveien 28 selskapslokale","DEMN",1,0,1
"0301","Oslo","0306","Grefsenveien 28 selskapslokale","DLF",0,1,1
"0301","Oslo","0306","Grefsenveien 28 selskapslokale","KSP",1,0,1
"0301","Oslo","0306","Grefsenveien 28 selskapslokale","MDG",53,22,75
"0301","Oslo","0306","Grefsenveien 28 selskapslokale","NKP",0,1,1
"0301","Oslo","0306","Grefsenveien 28 selskapslokale","PP",5,2,7
"0301","Oslo","0401","Marienlyst skole","A",110,102,212
"0301","Oslo","0401","Marienlyst skole","SV",28,10,38
"0301","Oslo","0401","Marienlyst skole","RØDT",20,11,31
"0301","Oslo","0401","Marienlyst skole","SP",5,4,9
"0301","Oslo","0401","Marienlyst skole","KRF",40,20,60
"0301","Oslo","0401","Marienlyst skole","V",54,27,81
"0301","Oslo","0401","Marienlyst skole","H",181,80,261
"0301","Oslo","0401","Marienlyst skole","FRP",28,23,51
"0301","Oslo","0401","Marienlyst skole","DEMN",1,0,1
"0301","Oslo","0401","Marienlyst skole","KSP",1,1,2
"0301","Oslo","0401","Marienlyst skole","MDG",15,7,22
"0301","Oslo","0401","Marienlyst skole","NKP",2,0,2
"0301","Oslo","0401","Marienlyst skole","PP",0,1,1
"0301","Oslo","0402","Fagerborg videregående skole","A",560,160,720
"0301","Oslo","0402","Fagerborg videregående skole","SV",155,63,218
"0301","Oslo","0402","Fagerborg videregående skole","RØDT",87,23,110
"0301","Oslo","0402","Fagerborg videregående skole","SP",8,3,11
"0301","Oslo","0402","Fagerborg videregående skole","KRF",57,25,82
"0301","Oslo","0402","Fagerborg videregående skole","V",297,65,362
"0301","Oslo","0402","Fagerborg videregående skole","H",948,220,1168
"0301","Oslo","0402","Fagerborg videregående skole","FRP",90,25,115
"0301","Oslo","0402","Fagerborg videregående skole","DLF",1,2,3
"0301","Oslo","0402","Fagerborg videregående skole","KSP",3,0,3
"0301","Oslo","0402","Fagerborg videregående skole","MDG",97,24,121
"0301","Oslo","0402","Fagerborg videregående skole","NKP",0,1,1
"0301","Oslo","0402","Fagerborg videregående skole","PP",10,4,14
"0301","Oslo","0403","Bolteløkka skole","A",840,267,1107
"0301","Oslo","0403","Bolteløkka skole","SV",261,88,349
"0301","Oslo","0403","Bolteløkka skole","RØDT",134,50,184
"0301","Oslo","0403","Bolteløkka skole","SP",17,5,22
"0301","Oslo","0403","Bolteløkka skole","KRF",75,20,95
"0301","Oslo","0403","Bolteløkka skole","V",431,93,524
"0301","Oslo","0403","Bolteløkka skole","H",1221,348,1569
"0301","Oslo","0403","Bolteløkka skole","FRP",134,32,166
"0301","Oslo","0403","Bolteløkka skole","DEMN",1,0,1
"0301","Oslo","0403","Bolteløkka skole","DLF",2,1,3
"0301","Oslo","0403","Bolteløkka skole","KSP",2,0,2
"0301","Oslo","0403","Bolteløkka skole","KYST",1,1,2
"0301","Oslo","0403","Bolteløkka skole","MDG",131,33,164
"0301","Oslo","0403","Bolteløkka skole","PP",5,4,9
"0301","Oslo","0404","Ila skole","A",679,319,998
"0301","Oslo","0404","Ila skole","SV",204,81,285
"0301","Oslo","0404","Ila skole","RØDT",121,40,161
"0301","Oslo","0404","Ila skole","SP",11,7,18
"0301","Oslo","0404","Ila skole","KRF",65,45,110
"0301","Oslo","0404","Ila skole","V",309,83,392
"0301","Oslo","0404","Ila skole","H",737,219,956
"0301","Oslo","0404","Ila skole","FRP",75,34,109
"0301","Oslo","0404","Ila skole","DEMN",2,1,3
"0301","Oslo","0404","Ila skole","DLF",2,2,4
"0301","Oslo","0404","Ila skole","KSP",5,0,5
"0301","Oslo","0404","Ila skole","MDG",106,44,150
"0301","Oslo","0404","Ila skole","NKP",1,0,1
"0301","Oslo","0404","Ila skole","PP",5,1,6
"0301","Oslo","0405","Oslo katedralskole","A",704,299,1003
"0301","Oslo","0405","Oslo katedralskole","SV",231,96,327
"0301","Oslo","0405","Oslo katedralskole","RØDT",120,57,177
"0301","Oslo","0405","Oslo katedralskole","SP",12,9,21
"0301","Oslo","0405","Oslo katedralskole","KRF",65,30,95
"0301","Oslo","0405","Oslo katedralskole","V",375,136,511
"0301","Oslo","0405","Oslo katedralskole","H",1066,384,1450
"0301","Oslo","0405","Oslo katedralskole","FRP",136,70,206
"0301","Oslo","0405","Oslo katedralskole","DLF",6,4,10
"0301","Oslo","0405","Oslo katedralskole","KSP",0,1,1
"0301","Oslo","0405","Oslo katedralskole","KYST",3,0,3
"0301","Oslo","0405","Oslo katedralskole","MDG",141,40,181
"0301","Oslo","0405","Oslo katedralskole","NKP",1,0,1
"0301","Oslo","0405","Oslo katedralskole","PP",8,1,9
"0301","Oslo","0406","Møllergata skole","A",289,107,396
"0301","Oslo","0406","Møllergata skole","SV",81,42,123
"0301","Oslo","0406","Møllergata skole","RØDT",63,27,90
"0301","Oslo","0406","Møllergata skole","SP",11,3,14
"0301","Oslo","0406","Møllergata skole","KRF",21,9,30
"0301","Oslo","0406","Møllergata skole","V",123,56,179
"0301","Oslo","0406","Møllergata skole","H",279,96,375
"0301","Oslo","0406","Møllergata skole","FRP",48,22,70
"0301","Oslo","0406","Møllergata skole","DEMN",2,0,2
"0301","Oslo","0406","Møllergata skole","DLF",4,1,5
"0301","Oslo","0406","Møllergata skole","KSP",4,1,5
"0301","Oslo","0406","Møllergata skole","KYST",1,0,1
"0301","Oslo","0406","Møllergata skole","MDG",64,23,87
"0301","Oslo","0406","Møllergata skole","NKP",1,0,1
"0301","Oslo","0406","Møllergata skole","PP",6,1,7
"0301","Oslo","0501","Politihøgskolen","A",538,355,893
"0301","Oslo","0501","Politihøgskolen","SV",144,75,219
"0301","Oslo","0501","Politihøgskolen","RØDT",87,52,139
"0301","Oslo","0501","Politihøgskolen","SP",10,13,23
"0301","Oslo","0501","Politihøgskolen","KRF",60,24,84
"0301","Oslo","0501","Politihøgskolen","V",249,99,348
"0301","Oslo","0501","Politihøgskolen","H",1172,714,1886
"0301","Oslo","0501","Politihøgskolen","FRP",121,84,205
"0301","Oslo","0501","Politihøgskolen","DLF",2,1,3
"0301","Oslo","0501","Politihøgskolen","KSP",3,1,4
"0301","Oslo","0501","Politihøgskolen","KYST",1,0,1
"0301","Oslo","0501","Politihøgskolen","MDG",73,28,101
"0301","Oslo","0501","Politihøgskolen","NKP",2,1,3
"0301","Oslo","0501","Politihøgskolen","PP",6,2,8
"0301","Oslo","0502","Majorstuen skole","A",305,141,446
"0301","Oslo","0502","Majorstuen skole","SV",57,37,94
"0301","Oslo","0502","Majorstuen skole","RØDT",45,23,68
"0301","Oslo","0502","Majorstuen skole","SP",5,7,12
"0301","Oslo","0502","Majorstuen skole","KRF",22,23,45
"0301","Oslo","0502","Majorstuen skole","V",169,51,220
"0301","Oslo","0502","Majorstuen skole","H",952,309,1261
"0301","Oslo","0502","Majorstuen skole","FRP",99,74,173
"0301","Oslo","0502","Majorstuen skole","DEMN",1,0,1
"0301","Oslo","0502","Majorstuen skole","DLF",5,0,5
"0301","Oslo","0502","Majorstuen skole","KYST",1,0,1
"0301","Oslo","0502","Majorstuen skole","MDG",41,11,52
"0301","Oslo","0502","Majorstuen skole","NKP",0,2,2
"0301","Oslo","0502","Majorstuen skole","PP",5,3,8
"0301","Oslo","0503","Kristelig gymnasium","A",402,205,607
"0301","Oslo","0503","Kristelig gymnasium","SV",117,48,165
"0301","Oslo","0503","Kristelig gymnasium","RØDT",67,37,104
"0301","Oslo","0503","Kristelig gymnasium","SP",9,9,18
"0301","Oslo","0503","Kristelig gymnasium","KRF",64,33,97
"0301","Oslo","0503","Kristelig gymnasium","V",249,75,324
"0301","Oslo","0503","Kristelig gymnasium","H",922,360,1282
"0301","Oslo","0503","Kristelig gymnasium","FRP",96,58,154
"0301","Oslo","0503","Kristelig gymnasium","DEMN",1,1,2
"0301","Oslo","0503","Kristelig gymnasium","DLF",4,1,5
"0301","Oslo","0503","Kristelig gymnasium","KSP",1,2,3
"0301","Oslo","0503","Kristelig gymnasium","KYST",1,1,2
"0301","Oslo","0503","Kristelig gymnasium","MDG",63,22,85
"0301","Oslo","0503","Kristelig gymnasium","NKP",4,2,6
"0301","Oslo","0503","Kristelig gymnasium","PP",5,2,7
"0301","Oslo","0504","Uranienborg menighetshus","A",244,91,335
"0301","Oslo","0504","Uranienborg menighetshus","SV",68,29,97
"0301","Oslo","0504","Uranienborg menighetshus","RØDT",37,21,58
"0301","Oslo","0504","Uranienborg menighetshus","SP",6,1,7
"0301","Oslo","0504","Uranienborg menighetshus","KRF",27,7,34
"0301","Oslo","0504","Uranienborg menighetshus","V",138,42,180
"0301","Oslo","0504","Uranienborg menighetshus","H",740,300,1040
"0301","Oslo","0504","Uranienborg menighetshus","FRP",88,40,128
"0301","Oslo","0504","Uranienborg menighetshus","DEMN",1,0,1
"0301","Oslo","0504","Uranienborg menighetshus","DLF",0,1,1
"0301","Oslo","0504","Uranienborg menighetshus","KYST",1,0,1
"0301","Oslo","0504","Uranienborg menighetshus","MDG",40,16,56
"0301","Oslo","0504","Uranienborg menighetshus","NKP",1,0,1
"0301","Oslo","0504","Uranienborg menighetshus","PP",2,2,4
"0301","Oslo","0505","Uranienborg skole","A",371,118,489
"0301","Oslo","0505","Uranienborg skole","SV",99,29,128
"0301","Oslo","0505","Uranienborg skole","RØDT",38,23,61
"0301","Oslo","0505","Uranienborg skole","SP",5,4,9
"0301","Oslo","0505","Uranienborg skole","KRF",34,12,46
"0301","Oslo","0505","Uranienborg skole","V",196,47,243
"0301","Oslo","0505","Uranienborg skole","H",1124,398,1522
"0301","Oslo","0505","Uranienborg skole","FRP",93,55,148
"0301","Oslo","0505","Uranienborg skole","DEMN",1,0,1
"0301","Oslo","0505","Uranienborg skole","DLF",4,0,4
"0301","Oslo","0505","Uranienborg skole","KSP",1,1,2
"0301","Oslo","0505","Uranienborg skole","MDG",50,11,61
"0301","Oslo","0505","Uranienborg skole","NKP",1,1,2
"0301","Oslo","0505","Uranienborg skole","PP",3,0,3
"0301","Oslo","0506","Frogner menighetshus/Schafteløkken","A",243,91,334
"0301","Oslo","0506","Frogner menighetshus/Schafteløkken","SV",55,26,81
"0301","Oslo","0506","Frogner menighetshus/Schafteløkken","RØDT",31,20,51
"0301","Oslo","0506","Frogner menighetshus/Schafteløkken","SP",6,2,8
"0301","Oslo","0506","Frogner menighetshus/Schafteløkken","KRF",18,6,24
"0301","Oslo","0506","Frogner menighetshus/Schafteløkken","V",141,48,189
"0301","Oslo","0506","Frogner menighetshus/Schafteløkken","H",937,393,1330
"0301","Oslo","0506","Frogner menighetshus/Schafteløkken","FRP",82,59,141
"0301","Oslo","0506","Frogner menighetshus/Schafteløkken","DLF",0,1,1
"0301","Oslo","0506","Frogner menighetshus/Schafteløkken","MDG",40,17,57
"0301","Oslo","0506","Frogner menighetshus/Schafteløkken","NKP",0,1,1
"0301","Oslo","0506","Frogner menighetshus/Schafteløkken","PP",3,0,3
"0301","Oslo","0507","Frogner kino","A",242,80,322
"0301","Oslo","0507","Frogner kino","SV",66,18,84
"0301","Oslo","0507","Frogner kino","RØDT",35,5,40
"0301","Oslo","0507","Frogner kino","SP",3,0,3
"0301","Oslo","0507","Frogner kino","KRF",14,1,15
"0301","Oslo","0507","Frogner kino","V",136,36,172
"0301","Oslo","0507","Frogner kino","H",858,401,1259
"0301","Oslo","0507","Frogner kino","FRP",105,36,141
"0301","Oslo","0507","Frogner kino","DEMN",1,1,2
"0301","Oslo","0507","Frogner kino","MDG",32,16,48
"0301","Oslo","0507","Frogner kino","PP",3,2,5
"0301","Oslo","0508","Oslo handelsgymnasium","A",541,206,747
"0301","Oslo","0508","Oslo handelsgymnasium","SV",131,50,181
"0301","Oslo","0508","Oslo handelsgymnasium","RØDT",70,19,89
"0301","Oslo","0508","Oslo handelsgymnasium","SP",8,4,12
"0301","Oslo","0508","Oslo handelsgymnasium","KRF",27,15,42
"0301","Oslo","0508","Oslo handelsgymnasium","V",268,81,349
"0301","Oslo","0508","Oslo handelsgymnasium","H",1548,596,2144
"0301","Oslo","0508","Oslo handelsgymnasium","FRP",170,89,259
"0301","Oslo","0508","Oslo handelsgymnasium","DEMN",0,1,1
"0301","Oslo","0508","Oslo handelsgymnasium","DLF",3,2,5
"0301","Oslo","0508","Oslo handelsgymnasium","KSP",1,2,3
"0301","Oslo","0508","Oslo handelsgymnasium","KYST",1,0,1
"0301","Oslo","0508","Oslo handelsgymnasium","MDG",84,36,120
"0301","Oslo","0508","Oslo handelsgymnasium","NKP",1,0,1
"0301","Oslo","0508","Oslo handelsgymnasium","PP",6,2,8
"0301","Oslo","0509","Ruseløkka skole","A",136,99,235
"0301","Oslo","0509","Ruseløkka skole","SV",24,34,58
"0301","Oslo","0509","Ruseløkka skole","RØDT",15,14,29
"0301","Oslo","0509","Ruseløkka skole","SP",2,4,6
"0301","Oslo","0509","Ruseløkka skole","KRF",10,7,17
"0301","Oslo","0509","Ruseløkka skole","V",92,50,142
"0301","Oslo","0509","Ruseløkka skole","H",428,353,781
"0301","Oslo","0509","Ruseløkka skole","FRP",51,62,113
"0301","Oslo","0509","Ruseløkka skole","DLF",4,1,5
"0301","Oslo","0509","Ruseløkka skole","KSP",1,1,2
"0301","Oslo","0509","Ruseløkka skole","KYST",2,0,2
"0301","Oslo","0509","Ruseløkka skole","MDG",25,11,36
"0301","Oslo","0509","Ruseløkka skole","NKP",0,1,1
"0301","Oslo","0509","Ruseløkka skole","PP",1,1,2
"0301","Oslo","0510","Bygdøy skole","A",177,59,236
"0301","Oslo","0510","Bygdøy skole","SV",33,12,45
"0301","Oslo","0510","Bygdøy skole","RØDT",11,5,16
"0301","Oslo","0510","Bygdøy skole","SP",2,1,3
"0301","Oslo","0510","Bygdøy skole","KRF",27,5,32
"0301","Oslo","0510","Bygdøy skole","V",109,20,129
"0301","Oslo","0510","Bygdøy skole","H",1027,268,1295
"0301","Oslo","0510","Bygdøy skole","FRP",111,49,160
"0301","Oslo","0510","Bygdøy skole","DLF",1,0,1
"0301","Oslo","0510","Bygdøy skole","KSP",1,0,1
"0301","Oslo","0510","Bygdøy skole","MDG",30,7,37
"0301","Oslo","0510","Bygdøy skole","NKP",1,0,1
"0301","Oslo","0510","Bygdøy skole","PP",0,1,1
"0301","Oslo","0601","Lysejordet skole","A",340,188,528
"0301","Oslo","0601","Lysejordet skole","SV",69,12,81
"0301","Oslo","0601","Lysejordet skole","RØDT",20,12,32
"0301","Oslo","0601","Lysejordet skole","SP",7,1,8
"0301","Oslo","0601","Lysejordet skole","KRF",46,19,65
"0301","Oslo","0601","Lysejordet skole","V",133,43,176
"0301","Oslo","0601","Lysejordet skole","H",1166,680,1846
"0301","Oslo","0601","Lysejordet skole","FRP",117,97,214
"0301","Oslo","0601","Lysejordet skole","DEMN",0,1,1
"0301","Oslo","0601","Lysejordet skole","DLF",1,0,1
"0301","Oslo","0601","Lysejordet skole","KSP",1,0,1
"0301","Oslo","0601","Lysejordet skole","KYST",0,1,1
"0301","Oslo","0601","Lysejordet skole","MDG",21,2,23
"0301","Oslo","0601","Lysejordet skole","PP",3,0,3
"0301","Oslo","0602","Øraker skole - idrettshall","A",369,256,625
"0301","Oslo","0602","Øraker skole - idrettshall","SV",88,21,109
"0301","Oslo","0602","Øraker skole - idrettshall","RØDT",26,11,37
"0301","Oslo","0602","Øraker skole - idrettshall","SP",20,3,23
"0301","Oslo","0602","Øraker skole - idrettshall","KRF",43,21,64
"0301","Oslo","0602","Øraker skole - idrettshall","V",226,84,310
"0301","Oslo","0602","Øraker skole - idrettshall","H",1371,745,2116
"0301","Oslo","0602","Øraker skole - idrettshall","FRP",117,105,222
"0301","Oslo","0602","Øraker skole - idrettshall","DEMN",1,1,2
"0301","Oslo","0602","Øraker skole - idrettshall","DLF",2,1,3
"0301","Oslo","0602","Øraker skole - idrettshall","KSP",1,0,1
"0301","Oslo","0602","Øraker skole - idrettshall","KYST",1,1,2
"0301","Oslo","0602","Øraker skole - idrettshall","MDG",35,16,51
"0301","Oslo","0602","Øraker skole - idrettshall","PP",4,3,7
"0301","Oslo","0603","Bestum skole","A",336,159,495
"0301","Oslo","0603","Bestum skole","SV",68,29,97
"0301","Oslo","0603","Bestum skole","RØDT",26,16,42
"0301","Oslo","0603","Bestum skole","SP",3,5,8
"0301","Oslo","0603","Bestum skole","KRF",24,12,36
"0301","Oslo","0603","Bestum skole","V",192,62,254
"0301","Oslo","0603","Bestum skole","H",1203,559,1762
"0301","Oslo","0603","Bestum skole","FRP",78,68,146
"0301","Oslo","0603","Bestum skole","KSP",0,1,1
"0301","Oslo","0603","Bestum skole","KYST",2,0,2
"0301","Oslo","0603","Bestum skole","MDG",26,10,36
"0301","Oslo","0603","Bestum skole","NKP",0,1,1
"0301","Oslo","0603","Bestum skole","PP",1,1,2
"0301","Oslo","0604","Smestad brannstasjon","A",177,98,275
"0301","Oslo","0604","Smestad brannstasjon","SV",18,14,32
"0301","Oslo","0604","Smestad brannstasjon","RØDT",13,6,19
"0301","Oslo","0604","Smestad brannstasjon","SP",0,1,1
"0301","Oslo","0604","Smestad brannstasjon","KRF",21,18,39
"0301","Oslo","0604","Smestad brannstasjon","V",106,38,144
"0301","Oslo","0604","Smestad brannstasjon","H",753,508,1261
"0301","Oslo","0604","Smestad brannstasjon","FRP",98,77,175
"0301","Oslo","0604","Smestad brannstasjon","KSP",1,0,1
"0301","Oslo","0604","Smestad brannstasjon","KYST",1,0,1
"0301","Oslo","0604","Smestad brannstasjon","MDG",11,4,15
"0301","Oslo","0604","Smestad brannstasjon","PP",1,1,2
"0301","Oslo","0605","Smestad skole","A",295,124,419
"0301","Oslo","0605","Smestad skole","SV",62,27,89
"0301","Oslo","0605","Smestad skole","RØDT",30,9,39
"0301","Oslo","0605","Smestad skole","SP",2,1,3
"0301","Oslo","0605","Smestad skole","KRF",20,3,23
"0301","Oslo","0605","Smestad skole","V",193,54,247
"0301","Oslo","0605","Smestad skole","H",960,343,1303
"0301","Oslo","0605","Smestad skole","FRP",81,52,133
"0301","Oslo","0605","Smestad skole","DEMN",1,0,1
"0301","Oslo","0605","Smestad skole","DLF",0,1,1
"0301","Oslo","0605","Smestad skole","KSP",3,1,4
"0301","Oslo","0605","Smestad skole","MDG",24,5,29
"0301","Oslo","0605","Smestad skole","NKP",1,0,1
"0301","Oslo","0605","Smestad skole","PP",4,1,5
"0301","Oslo","0606","Skøyen skole - idrettshallen","A",504,192,696
"0301","Oslo","0606","Skøyen skole - idrettshallen","SV",123,39,162
"0301","Oslo","0606","Skøyen skole - idrettshallen","RØDT",38,16,54
"0301","Oslo","0606","Skøyen skole - idrettshallen","SP",11,2,13
"0301","Oslo","0606","Skøyen skole - idrettshallen","KRF",42,21,63
"0301","Oslo","0606","Skøyen skole - idrettshallen","V",246,51,297
"0301","Oslo","0606","Skøyen skole - idrettshallen","H",1206,474,1680
"0301","Oslo","0606","Skøyen skole - idrettshallen","FRP",127,59,186
"0301","Oslo","0606","Skøyen skole - idrettshallen","MDG",44,7,51
"0301","Oslo","0606","Skøyen skole - idrettshallen","NKP",1,1,2
"0301","Oslo","0606","Skøyen skole - idrettshallen","PP",8,2,10
"0301","Oslo","0701","Vinderen skole","A",199,85,284
"0301","Oslo","0701","Vinderen skole","SV",65,21,86
"0301","Oslo","0701","Vinderen skole","RØDT",24,14,38
"0301","Oslo","0701","Vinderen skole","SP",10,1,11
"0301","Oslo","0701","Vinderen skole","KRF",39,12,51
"0301","Oslo","0701","Vinderen skole","V",162,35,197
"0301","Oslo","0701","Vinderen skole","H",892,309,1201
"0301","Oslo","0701","Vinderen skole","FRP",59,40,99
"0301","Oslo","0701","Vinderen skole","DEMN",0,1,1
"0301","Oslo","0701","Vinderen skole","KSP",1,0,1
"0301","Oslo","0701","Vinderen skole","MDG",33,18,51
"0301","Oslo","0701","Vinderen skole","PP",2,0,2
"0301","Oslo","0702","Ris skole","A",172,86,258
"0301","Oslo","0702","Ris skole","SV",51,18,69
"0301","Oslo","0702","Ris skole","RØDT",16,7,23
"0301","Oslo","0702","Ris skole","SP",1,4,5
"0301","Oslo","0702","Ris skole","KRF",19,5,24
"0301","Oslo","0702","Ris skole","V",135,37,172
"0301","Oslo","0702","Ris skole","H",885,319,1204
"0301","Oslo","0702","Ris skole","FRP",53,34,87
"0301","Oslo","0702","Ris skole","DLF",1,2,3
"0301","Oslo","0702","Ris skole","KYST",2,0,2
"0301","Oslo","0702","Ris skole","MDG",15,8,23
"0301","Oslo","0702","Ris skole","PP",2,2,4
"0301","Oslo","0703","Slemdal skole","A",281,92,373
"0301","Oslo","0703","Slemdal skole","SV",50,14,64
"0301","Oslo","0703","Slemdal skole","RØDT",21,13,34
"0301","Oslo","0703","Slemdal skole","SP",5,0,5
"0301","Oslo","0703","Slemdal skole","KRF",43,14,57
"0301","Oslo","0703","Slemdal skole","V",215,60,275
"0301","Oslo","0703","Slemdal skole","H",1721,556,2277
"0301","Oslo","0703","Slemdal skole","FRP",122,54,176
"0301","Oslo","0703","Slemdal skole","KSP",2,0,2
"0301","Oslo","0703","Slemdal skole","KYST",1,0,1
"0301","Oslo","0703","Slemdal skole","MDG",34,7,41
"0301","Oslo","0703","Slemdal skole","NKP",1,1,2
"0301","Oslo","0703","Slemdal skole","PP",6,1,7
"0301","Oslo","0704","Svendstuen skole","A",230,97,327
"0301","Oslo","0704","Svendstuen skole","SV",37,28,65
"0301","Oslo","0704","Svendstuen skole","RØDT",14,9,23
"0301","Oslo","0704","Svendstuen skole","SP",4,1,5
"0301","Oslo","0704","Svendstuen skole","KRF",26,9,35
"0301","Oslo","0704","Svendstuen skole","V",221,74,295
"0301","Oslo","0704","Svendstuen skole","H",1849,768,2617
"0301","Oslo","0704","Svendstuen skole","FRP",115,92,207
"0301","Oslo","0704","Svendstuen skole","DEMN",1,0,1
"0301","Oslo","0704","Svendstuen skole","DLF",1,0,1
"0301","Oslo","0704","Svendstuen skole","MDG",40,11,51
"0301","Oslo","0704","Svendstuen skole","NKP",1,0,1
"0301","Oslo","0704","Svendstuen skole","PP",0,3,3
"0301","Oslo","0705","Grindbakken skole","A",324,141,465
"0301","Oslo","0705","Grindbakken skole","SV",49,15,64
"0301","Oslo","0705","Grindbakken skole","RØDT",22,4,26
"0301","Oslo","0705","Grindbakken skole","SP",3,4,7
"0301","Oslo","0705","Grindbakken skole","KRF",46,15,61
"0301","Oslo","0705","Grindbakken skole","V",150,39,189
"0301","Oslo","0705","Grindbakken skole","H",1279,414,1693
"0301","Oslo","0705","Grindbakken skole","FRP",138,72,210
"0301","Oslo","0705","Grindbakken skole","KSP",1,0,1
"0301","Oslo","0705","Grindbakken skole","MDG",23,9,32
"0301","Oslo","0705","Grindbakken skole","PP",6,7,13
"0301","Oslo","0706","Bogstad skole","A",371,125,496
"0301","Oslo","0706","Bogstad skole","SV",80,19,99
"0301","Oslo","0706","Bogstad skole","RØDT",24,9,33
"0301","Oslo","0706","Bogstad skole","SP",7,2,9
"0301","Oslo","0706","Bogstad skole","KRF",33,8,41
"0301","Oslo","0706","Bogstad skole","V",224,62,286
"0301","Oslo","0706","Bogstad skole","H",1131,356,1487
"0301","Oslo","0706","Bogstad skole","FRP",110,40,150
"0301","Oslo","0706","Bogstad skole","DEMN",1,0,1
"0301","Oslo","0706","Bogstad skole","DLF",1,2,3
"0301","Oslo","0706","Bogstad skole","MDG",23,4,27
"0301","Oslo","0706","Bogstad skole","NKP",2,0,2
"0301","Oslo","0706","Bogstad skole","PP",1,2,3
"0301","Oslo","0707","Huseby skole","A",304,98,402
"0301","Oslo","0707","Huseby skole","SV",64,6,70
"0301","Oslo","0707","Huseby skole","RØDT",27,13,40
"0301","Oslo","0707","Huseby skole","SP",7,3,10
"0301","Oslo","0707","Huseby skole","KRF",48,20,68
"0301","Oslo","0707","Huseby skole","V",193,34,227
"0301","Oslo","0707","Huseby skole","H",984,400,1384
"0301","Oslo","0707","Huseby skole","FRP",105,57,162
"0301","Oslo","0707","Huseby skole","DEMN",0,1,1
"0301","Oslo","0707","Huseby skole","MDG",36,11,47
"0301","Oslo","0707","Huseby skole","NKP",1,0,1
"0301","Oslo","0707","Huseby skole","PP",4,2,6
"0301","Oslo","0708","Hovseter skole","A",655,212,867
"0301","Oslo","0708","Hovseter skole","SV",130,35,165
"0301","Oslo","0708","Hovseter skole","RØDT",73,20,93
"0301","Oslo","0708","Hovseter skole","SP",10,3,13
"0301","Oslo","0708","Hovseter skole","KRF",74,20,94
"0301","Oslo","0708","Hovseter skole","V",231,54,285
"0301","Oslo","0708","Hovseter skole","H",971,313,1284
"0301","Oslo","0708","Hovseter skole","FRP",126,56,182
"0301","Oslo","0708","Hovseter skole","DEMN",1,0,1
"0301","Oslo","0708","Hovseter skole","DLF",1,0,1
"0301","Oslo","0708","Hovseter skole","MDG",37,16,53
"0301","Oslo","0708","Hovseter skole","NKP",1,1,2
"0301","Oslo","0708","Hovseter skole","PP",4,5,9
"0301","Oslo","0709","Persbråten videregående skole","A",283,91,374
"0301","Oslo","0709","Persbråten videregående skole","SV",74,21,95
"0301","Oslo","0709","Persbråten videregående skole","RØDT",47,12,59
"0301","Oslo","0709","Persbråten videregående skole","SP",7,1,8
"0301","Oslo","0709","Persbråten videregående skole","KRF",32,15,47
"0301","Oslo","0709","Persbråten videregående skole","V",205,48,253
"0301","Oslo","0709","Persbråten videregående skole","H",1061,332,1393
"0301","Oslo","0709","Persbråten videregående skole","FRP",79,34,113
"0301","Oslo","0709","Persbråten videregående skole","DLF",0,1,1
"0301","Oslo","0709","Persbråten videregående skole","KSP",1,0,1
"0301","Oslo","0709","Persbråten videregående skole","MDG",28,11,39
"0301","Oslo","0709","Persbråten videregående skole","NKP",1,0,1
"0301","Oslo","0709","Persbråten videregående skole","PP",2,0,2
"0301","Oslo","0801","Ullevål skole","A",653,204,857
"0301","Oslo","0801","Ullevål skole","SV",249,60,309
"0301","Oslo","0801","Ullevål skole","RØDT",111,40,151
"0301","Oslo","0801","Ullevål skole","SP",8,1,9
"0301","Oslo","0801","Ullevål skole","KRF",55,22,77
"0301","Oslo","0801","Ullevål skole","V",321,89,410
"0301","Oslo","0801","Ullevål skole","H",856,239,1095
"0301","Oslo","0801","Ullevål skole","FRP",80,30,110
"0301","Oslo","0801","Ullevål skole","DEMN",1,0,1
"0301","Oslo","0801","Ullevål skole","DLF",0,1,1
"0301","Oslo","0801","Ullevål skole","KSP",1,0,1
"0301","Oslo","0801","Ullevål skole","MDG",94,22,116
"0301","Oslo","0801","Ullevål skole","NKP",0,1,1
"0301","Oslo","0801","Ullevål skole","PP",7,1,8
"0301","Oslo","0802","Sogn videregående skole","A",415,171,586
"0301","Oslo","0802","Sogn videregående skole","SV",147,35,182
"0301","Oslo","0802","Sogn videregående skole","RØDT",77,25,102
"0301","Oslo","0802","Sogn videregående skole","SP",10,1,11
"0301","Oslo","0802","Sogn videregående skole","KRF",42,16,58
"0301","Oslo","0802","Sogn videregående skole","V",158,49,207
"0301","Oslo","0802","Sogn videregående skole","H",501,142,643
"0301","Oslo","0802","Sogn videregående skole","FRP",52,25,77
"0301","Oslo","0802","Sogn videregående skole","DEMN",1,0,1
"0301","Oslo","0802","Sogn videregående skole","DLF",1,1,2
"0301","Oslo","0802","Sogn videregående skole","MDG",51,27,78
"0301","Oslo","0802","Sogn videregående skole","NKP",2,2,4
"0301","Oslo","0802","Sogn videregående skole","PP",1,0,1
"0301","Oslo","0803","Kringsjå skole","A",338,124,462
"0301","Oslo","0803","Kringsjå skole","SV",100,34,134
"0301","Oslo","0803","Kringsjå skole","RØDT",43,21,64
"0301","Oslo","0803","Kringsjå skole","SP",11,6,17
"0301","Oslo","0803","Kringsjå skole","KRF",52,16,68
"0301","Oslo","0803","Kringsjå skole","V",151,40,191
"0301","Oslo","0803","Kringsjå skole","H",441,132,573
"0301","Oslo","0803","Kringsjå skole","FRP",73,17,90
"0301","Oslo","0803","Kringsjå skole","DLF",1,0,1
"0301","Oslo","0803","Kringsjå skole","KSP",3,0,3
"0301","Oslo","0803","Kringsjå skole","MDG",37,26,63
"0301","Oslo","0803","Kringsjå skole","NKP",2,1,3
"0301","Oslo","0803","Kringsjå skole","PP",4,0,4
"0301","Oslo","0804","Korsvoll skole","A",564,144,708
"0301","Oslo","0804","Korsvoll skole","SV",153,37,190
"0301","Oslo","0804","Korsvoll skole","RØDT",52,21,73
"0301","Oslo","0804","Korsvoll skole","SP",4,3,7
"0301","Oslo","0804","Korsvoll skole","KRF",72,22,94
"0301","Oslo","0804","Korsvoll skole","V",208,42,250
"0301","Oslo","0804","Korsvoll skole","H",931,216,1147
"0301","Oslo","0804","Korsvoll skole","FRP",131,27,158
"0301","Oslo","0804","Korsvoll skole","DEMN",1,1,2
"0301","Oslo","0804","Korsvoll skole","DLF",1,0,1
"0301","Oslo","0804","Korsvoll skole","KSP",2,2,4
"0301","Oslo","0804","Korsvoll skole","KYST",1,0,1
"0301","Oslo","0804","Korsvoll skole","MDG",50,18,68
"0301","Oslo","0804","Korsvoll skole","PP",3,0,3
"0301","Oslo","0805","Tåsen skole","A",739,203,942
"0301","Oslo","0805","Tåsen skole","SV",177,38,215
"0301","Oslo","0805","Tåsen skole","RØDT",82,17,99
"0301","Oslo","0805","Tåsen skole","SP",12,3,15
"0301","Oslo","0805","Tåsen skole","KRF",82,32,114
"0301","Oslo","0805","Tåsen skole","V",328,82,410
"0301","Oslo","0805","Tåsen skole","H",1212,325,1537
"0301","Oslo","0805","Tåsen skole","FRP",153,65,218
"0301","Oslo","0805","Tåsen skole","DEMN",1,1,2
"0301","Oslo","0805","Tåsen skole","DLF",1,1,2
"0301","Oslo","0805","Tåsen skole","KSP",2,0,2
"0301","Oslo","0805","Tåsen skole","KYST",1,0,1
"0301","Oslo","0805","Tåsen skole","MDG",59,13,72
"0301","Oslo","0805","Tåsen skole","NKP",2,0,2
"0301","Oslo","0805","Tåsen skole","PP",6,0,6
"0301","Oslo","0806","Trikkehallen på Kjelsås","A",765,221,986
"0301","Oslo","0806","Trikkehallen på Kjelsås","SV",166,40,206
"0301","Oslo","0806","Trikkehallen på Kjelsås","RØDT",85,23,108
"0301","Oslo","0806","Trikkehallen på Kjelsås","SP",10,3,13
"0301","Oslo","0806","Trikkehallen på Kjelsås","KRF",67,15,82
"0301","Oslo","0806","Trikkehallen på Kjelsås","V",262,44,306
"0301","Oslo","0806","Trikkehallen på Kjelsås","H",901,220,1121
"0301","Oslo","0806","Trikkehallen på Kjelsås","FRP",130,42,172
"0301","Oslo","0806","Trikkehallen på Kjelsås","DLF",2,0,2
"0301","Oslo","0806","Trikkehallen på Kjelsås","KSP",2,0,2
"0301","Oslo","0806","Trikkehallen på Kjelsås","MDG",49,11,60
"0301","Oslo","0806","Trikkehallen på Kjelsås","NKP",2,0,2
"0301","Oslo","0806","Trikkehallen på Kjelsås","PP",5,1,6
"0301","Oslo","0807","Engebråten skole","A",400,130,530
"0301","Oslo","0807","Engebråten skole","SV",81,21,102
"0301","Oslo","0807","Engebråten skole","RØDT",24,12,36
"0301","Oslo","0807","Engebråten skole","SP",6,1,7
"0301","Oslo","0807","Engebråten skole","KRF",35,10,45
"0301","Oslo","0807","Engebråten skole","V",112,34,146
"0301","Oslo","0807","Engebråten skole","H",514,138,652
"0301","Oslo","0807","Engebråten skole","FRP",98,35,133
"0301","Oslo","0807","Engebråten skole","KYST",0,1,1
"0301","Oslo","0807","Engebråten skole","MDG",30,4,34
"0301","Oslo","0807","Engebråten skole","PP",4,3,7
"0301","Oslo","0808","Grefsen skole","A",673,282,955
"0301","Oslo","0808","Grefsen skole","SV",123,55,178
"0301","Oslo","0808","Grefsen skole","RØDT",62,21,83
"0301","Oslo","0808","Grefsen skole","SP",9,4,13
"0301","Oslo","0808","Grefsen skole","KRF",91,34,125
"0301","Oslo","0808","Grefsen skole","V",256,73,329
"0301","Oslo","0808","Grefsen skole","H",1007,322,1329
"0301","Oslo","0808","Grefsen skole","FRP",166,70,236
"0301","Oslo","0808","Grefsen skole","DEMN",2,1,3
"0301","Oslo","0808","Grefsen skole","DLF",1,1,2
"0301","Oslo","0808","Grefsen skole","KSP",1,1,2
"0301","Oslo","0808","Grefsen skole","KYST",3,0,3
"0301","Oslo","0808","Grefsen skole","MDG",24,16,40
"0301","Oslo","0808","Grefsen skole","PP",3,3,6
"0301","Oslo","0809","Disen skole","A",443,104,547
"0301","Oslo","0809","Disen skole","SV",101,30,131
"0301","Oslo","0809","Disen skole","RØDT",52,14,66
"0301","Oslo","0809","Disen skole","SP",4,3,7
"0301","Oslo","0809","Disen skole","KRF",72,14,86
"0301","Oslo","0809","Disen skole","V",153,27,180
"0301","Oslo","0809","Disen skole","H",749,157,906
"0301","Oslo","0809","Disen skole","FRP",163,44,207
"0301","Oslo","0809","Disen skole","DEMN",3,0,3
"0301","Oslo","0809","Disen skole","KSP",1,0,1
"0301","Oslo","0809","Disen skole","KYST",1,0,1
"0301","Oslo","0809","Disen skole","MDG",27,5,32
"0301","Oslo","0809","Disen skole","PP",2,1,3
"0301","Oslo","0810","Skeidhuset","A",455,92,547
"0301","Oslo","0810","Skeidhuset","SV",81,22,103
"0301","Oslo","0810","Skeidhuset","RØDT",29,10,39
"0301","Oslo","0810","Skeidhuset","SP",4,1,5
"0301","Oslo","0810","Skeidhuset","KRF",44,6,50
"0301","Oslo","0810","Skeidhuset","V",112,26,138
"0301","Oslo","0810","Skeidhuset","H",501,64,565
"0301","Oslo","0810","Skeidhuset","FRP",80,17,97
"0301","Oslo","0810","Skeidhuset","DLF",3,1,4
"0301","Oslo","0810","Skeidhuset","KSP",1,1,2
"0301","Oslo","0810","Skeidhuset","KYST",1,0,1
"0301","Oslo","0810","Skeidhuset","MDG",29,3,32
"0301","Oslo","0810","Skeidhuset","NKP",1,0,1
"0301","Oslo","0810","Skeidhuset","PP",5,0,5
"0301","Oslo","0901","Løren skole","A",909,490,1399
"0301","Oslo","0901","Løren skole","SV",139,60,199
"0301","Oslo","0901","Løren skole","RØDT",88,34,122
"0301","Oslo","0901","Løren skole","SP",12,16,28
"0301","Oslo","0901","Løren skole","KRF",62,25,87
"0301","Oslo","0901","Løren skole","V",179,40,219
"0301","Oslo","0901","Løren skole","H",858,256,1114
"0301","Oslo","0901","Løren skole","FRP",221,88,309
"0301","Oslo","0901","Løren skole","DEMN",1,1,2
"0301","Oslo","0901","Løren skole","DLF",1,0,1
"0301","Oslo","0901","Løren skole","KSP",3,0,3
"0301","Oslo","0901","Løren skole","KYST",3,1,4
"0301","Oslo","0901","Løren skole","MDG",37,11,48
"0301","Oslo","0901","Løren skole","NKP",3,2,5
"0301","Oslo","0901","Løren skole","PP",4,5,9
"0301","Oslo","0902","Årvoll skole","A",952,262,1214
"0301","Oslo","0902","Årvoll skole","SV",141,28,169
"0301","Oslo","0902","Årvoll skole","RØDT",83,22,105
"0301","Oslo","0902","Årvoll skole","SP",8,8,16
"0301","Oslo","0902","Årvoll skole","KRF",56,16,72
"0301","Oslo","0902","Årvoll skole","V",159,34,193
"0301","Oslo","0902","Årvoll skole","H",792,156,948
"0301","Oslo","0902","Årvoll skole","FRP",201,47,248
"0301","Oslo","0902","Årvoll skole","DEMN",0,1,1
"0301","Oslo","0902","Årvoll skole","DLF",1,1,2
"0301","Oslo","0902","Årvoll skole","KSP",3,1,4
"0301","Oslo","0902","Årvoll skole","KYST",0,1,1
"0301","Oslo","0902","Årvoll skole","MDG",43,7,50
"0301","Oslo","0902","Årvoll skole","NKP",2,1,3
"0301","Oslo","0902","Årvoll skole","PP",6,2,8
"0301","Oslo","0903","Tonsenhagen skole","A",583,128,711
"0301","Oslo","0903","Tonsenhagen skole","SV",88,19,107
"0301","Oslo","0903","Tonsenhagen skole","RØDT",76,14,90
"0301","Oslo","0903","Tonsenhagen skole","SP",12,2,14
"0301","Oslo","0903","Tonsenhagen skole","KRF",55,25,80
"0301","Oslo","0903","Tonsenhagen skole","V",110,22,132
"0301","Oslo","0903","Tonsenhagen skole","H",474,62,536
"0301","Oslo","0903","Tonsenhagen skole","FRP",151,18,169
"0301","Oslo","0903","Tonsenhagen skole","DEMN",2,1,3
"0301","Oslo","0903","Tonsenhagen skole","DLF",2,1,3
"0301","Oslo","0903","Tonsenhagen skole","KSP",2,1,3
"0301","Oslo","0903","Tonsenhagen skole","MDG",41,1,42
"0301","Oslo","0903","Tonsenhagen skole","PP",9,3,12
"0301","Oslo","0904","Linderud skole","A",555,164,719
"0301","Oslo","0904","Linderud skole","SV",45,27,72
"0301","Oslo","0904","Linderud skole","RØDT",39,9,48
"0301","Oslo","0904","Linderud skole","SP",8,4,12
"0301","Oslo","0904","Linderud skole","KRF",36,6,42
"0301","Oslo","0904","Linderud skole","V",35,12,47
"0301","Oslo","0904","Linderud skole","H",278,81,359
"0301","Oslo","0904","Linderud skole","FRP",104,35,139
"0301","Oslo","0904","Linderud skole","DLF",2,0,2
"0301","Oslo","0904","Linderud skole","KSP",1,0,1
"0301","Oslo","0904","Linderud skole","MDG",10,1,11
"0301","Oslo","0904","Linderud skole","NKP",2,0,2
"0301","Oslo","0904","Linderud skole","PP",6,1,7
"0301","Oslo","0905","Veitvet skole","A",703,282,985
"0301","Oslo","0905","Veitvet skole","SV",85,24,109
"0301","Oslo","0905","Veitvet skole","RØDT",61,28,89
"0301","Oslo","0905","Veitvet skole","SP",14,8,22
"0301","Oslo","0905","Veitvet skole","KRF",27,11,38
"0301","Oslo","0905","Veitvet skole","V",49,15,64
"0301","Oslo","0905","Veitvet skole","H",348,92,440
"0301","Oslo","0905","Veitvet skole","FRP",154,76,230
"0301","Oslo","0905","Veitvet skole","DEMN",1,0,1
"0301","Oslo","0905","Veitvet skole","DLF",1,0,1
"0301","Oslo","0905","Veitvet skole","KSP",1,0,1
"0301","Oslo","0905","Veitvet skole","KYST",3,0,3
"0301","Oslo","0905","Veitvet skole","MDG",15,7,22
"0301","Oslo","0905","Veitvet skole","NKP",3,2,5
"0301","Oslo","0905","Veitvet skole","PP",7,6,13
"0301","Oslo","1001","Rødtvet skole","A",621,136,757
"0301","Oslo","1001","Rødtvet skole","SV",56,17,73
"0301","Oslo","1001","Rødtvet skole","RØDT",69,8,77
"0301","Oslo","1001","Rødtvet skole","SP",8,3,11
"0301","Oslo","1001","Rødtvet skole","KRF",26,7,33
"0301","Oslo","1001","Rødtvet skole","V",58,9,67
"0301","Oslo","1001","Rødtvet skole","H",323,63,386
"0301","Oslo","1001","Rødtvet skole","FRP",148,34,182
"0301","Oslo","1001","Rødtvet skole","DEMN",3,0,3
"0301","Oslo","1001","Rødtvet skole","KSP",1,1,2
"0301","Oslo","1001","Rødtvet skole","KYST",6,0,6
"0301","Oslo","1001","Rødtvet skole","MDG",13,4,17
"0301","Oslo","1001","Rødtvet skole","NKP",0,1,1
"0301","Oslo","1001","Rødtvet skole","PP",8,1,9
"0301","Oslo","1002","Nordtvet skole","A",1252,335,1587
"0301","Oslo","1002","Nordtvet skole","SV",130,26,156
"0301","Oslo","1002","Nordtvet skole","RØDT",104,23,127
"0301","Oslo","1002","Nordtvet skole","SP",8,3,11
"0301","Oslo","1002","Nordtvet skole","KRF",58,6,64
"0301","Oslo","1002","Nordtvet skole","V",94,26,120
"0301","Oslo","1002","Nordtvet skole","H",590,103,693
"0301","Oslo","1002","Nordtvet skole","FRP",260,66,326
"0301","Oslo","1002","Nordtvet skole","DEMN",1,2,3
"0301","Oslo","1002","Nordtvet skole","DLF",2,0,2
"0301","Oslo","1002","Nordtvet skole","KSP",2,0,2
"0301","Oslo","1002","Nordtvet skole","KYST",1,0,1
"0301","Oslo","1002","Nordtvet skole","MDG",27,8,35
"0301","Oslo","1002","Nordtvet skole","NKP",1,1,2
"0301","Oslo","1002","Nordtvet skole","PP",10,4,14
"0301","Oslo","1003","Ammerud skole","A",1357,562,1919
"0301","Oslo","1003","Ammerud skole","SV",139,48,187
"0301","Oslo","1003","Ammerud skole","RØDT",125,36,161
"0301","Oslo","1003","Ammerud skole","SP",18,5,23
"0301","Oslo","1003","Ammerud skole","KRF",43,11,54
"0301","Oslo","1003","Ammerud skole","V",153,27,180
"0301","Oslo","1003","Ammerud skole","H",641,193,834
"0301","Oslo","1003","Ammerud skole","FRP",261,88,349
"0301","Oslo","1003","Ammerud skole","DEMN",3,1,4
"0301","Oslo","1003","Ammerud skole","DLF",2,1,3
"0301","Oslo","1003","Ammerud skole","KSP",1,0,1
"0301","Oslo","1003","Ammerud skole","KYST",1,1,2
"0301","Oslo","1003","Ammerud skole","MDG",30,3,33
"0301","Oslo","1003","Ammerud skole","NKP",4,1,5
"0301","Oslo","1003","Ammerud skole","PP",12,8,20
"0301","Oslo","1004","Tiurleiken skole","A",1152,309,1461
"0301","Oslo","1004","Tiurleiken skole","SV",89,29,118
"0301","Oslo","1004","Tiurleiken skole","RØDT",86,21,107
"0301","Oslo","1004","Tiurleiken skole","SP",8,7,15
"0301","Oslo","1004","Tiurleiken skole","KRF",60,6,66
"0301","Oslo","1004","Tiurleiken skole","V",59,22,81
"0301","Oslo","1004","Tiurleiken skole","H",365,97,462
"0301","Oslo","1004","Tiurleiken skole","FRP",260,48,308
"0301","Oslo","1004","Tiurleiken skole","DEMN",4,1,5
"0301","Oslo","1004","Tiurleiken skole","DLF",1,1,2
"0301","Oslo","1004","Tiurleiken skole","KSP",9,0,9
"0301","Oslo","1004","Tiurleiken skole","KYST",1,2,3
"0301","Oslo","1004","Tiurleiken skole","MDG",21,4,25
"0301","Oslo","1004","Tiurleiken skole","PP",22,9,31
"0301","Oslo","1101","Tokerud skole","A",854,342,1196
"0301","Oslo","1101","Tokerud skole","SV",91,31,122
"0301","Oslo","1101","Tokerud skole","RØDT",51,16,67
"0301","Oslo","1101","Tokerud skole","SP",5,5,10
"0301","Oslo","1101","Tokerud skole","KRF",39,18,57
"0301","Oslo","1101","Tokerud skole","V",37,18,55
"0301","Oslo","1101","Tokerud skole","H",419,114,533
"0301","Oslo","1101","Tokerud skole","FRP",229,67,296
"0301","Oslo","1101","Tokerud skole","DEMN",2,0,2
"0301","Oslo","1101","Tokerud skole","DLF",2,1,3
"0301","Oslo","1101","Tokerud skole","KSP",1,0,1
"0301","Oslo","1101","Tokerud skole","MDG",14,2,16
"0301","Oslo","1101","Tokerud skole","NKP",2,1,3
"0301","Oslo","1101","Tokerud skole","PP",14,7,21
"0301","Oslo","1102","Stovner videregående skole","A",767,368,1135
"0301","Oslo","1102","Stovner videregående skole","SV",70,18,88
"0301","Oslo","1102","Stovner videregående skole","RØDT",34,9,43
"0301","Oslo","1102","Stovner videregående skole","SP",5,15,20
"0301","Oslo","1102","Stovner videregående skole","KRF",22,14,36
"0301","Oslo","1102","Stovner videregående skole","V",33,7,40
"0301","Oslo","1102","Stovner videregående skole","H",256,88,344
"0301","Oslo","1102","Stovner videregående skole","FRP",146,67,213
"0301","Oslo","1102","Stovner videregående skole","DEMN",2,0,2
"0301","Oslo","1102","Stovner videregående skole","KSP",2,0,2
"0301","Oslo","1102","Stovner videregående skole","KYST",1,1,2
"0301","Oslo","1102","Stovner videregående skole","MDG",9,2,11
"0301","Oslo","1102","Stovner videregående skole","NKP",0,2,2
"0301","Oslo","1102","Stovner videregående skole","PP",9,4,13
"0301","Oslo","1103","Stovner skole","A",1123,424,1547
"0301","Oslo","1103","Stovner skole","SV",102,52,154
"0301","Oslo","1103","Stovner skole","RØDT",55,22,77
"0301","Oslo","1103","Stovner skole","SP",8,12,20
"0301","Oslo","1103","Stovner skole","KRF",64,15,79
"0301","Oslo","1103","Stovner skole","V",61,13,74
"0301","Oslo","1103","Stovner skole","H",671,194,865
"0301","Oslo","1103","Stovner skole","FRP",319,113,432
"0301","Oslo","1103","Stovner skole","DEMN",1,0,1
"0301","Oslo","1103","Stovner skole","DLF",6,0,6
"0301","Oslo","1103","Stovner skole","KSP",2,1,3
"0301","Oslo","1103","Stovner skole","KYST",2,0,2
"0301","Oslo","1103","Stovner skole","MDG",18,8,26
"0301","Oslo","1103","Stovner skole","NKP",4,2,6
"0301","Oslo","1103","Stovner skole","PP",20,11,31
"0301","Oslo","1104","Stig skole","A",567,198,765
"0301","Oslo","1104","Stig skole","SV",42,15,57
"0301","Oslo","1104","Stig skole","RØDT",41,7,48
"0301","Oslo","1104","Stig skole","SP",4,3,7
"0301","Oslo","1104","Stig skole","KRF",23,7,30
"0301","Oslo","1104","Stig skole","V",30,9,39
"0301","Oslo","1104","Stig skole","H",226,66,292
"0301","Oslo","1104","Stig skole","FRP",114,59,173
"0301","Oslo","1104","Stig skole","DEMN",3,0,3
"0301","Oslo","1104","Stig skole","DLF",1,0,1
"0301","Oslo","1104","Stig skole","KSP",2,0,2
"0301","Oslo","1104","Stig skole","KYST",2,0,2
"0301","Oslo","1104","Stig skole","MDG",6,2,8
"0301","Oslo","1104","Stig skole","NKP",4,0,4
"0301","Oslo","1104","Stig skole","PP",4,2,6
"0301","Oslo","1105","FolkvangHøybråten","A",1009,256,1265
"0301","Oslo","1105","FolkvangHøybråten","SV",125,23,148
"0301","Oslo","1105","FolkvangHøybråten","RØDT",57,13,70
"0301","Oslo","1105","FolkvangHøybråten","SP",13,4,17
"0301","Oslo","1105","FolkvangHøybråten","KRF",72,12,84
"0301","Oslo","1105","FolkvangHøybråten","V",83,16,99
"0301","Oslo","1105","FolkvangHøybråten","H",983,156,1139
"0301","Oslo","1105","FolkvangHøybråten","FRP",343,95,438
"0301","Oslo","1105","FolkvangHøybråten","DEMN",1,0,1
"0301","Oslo","1105","FolkvangHøybråten","DLF",2,1,3
"0301","Oslo","1105","FolkvangHøybråten","KSP",1,1,2
"0301","Oslo","1105","FolkvangHøybråten","MDG",14,5,19
"0301","Oslo","1105","FolkvangHøybråten","PP",12,4,16
"0301","Oslo","1201","Ellingsrudåsen skole","A",1030,374,1404
"0301","Oslo","1201","Ellingsrudåsen skole","SV",95,40,135
"0301","Oslo","1201","Ellingsrudåsen skole","RØDT",52,13,65
"0301","Oslo","1201","Ellingsrudåsen skole","SP",8,8,16
"0301","Oslo","1201","Ellingsrudåsen skole","KRF",32,12,44
"0301","Oslo","1201","Ellingsrudåsen skole","V",76,14,90
"0301","Oslo","1201","Ellingsrudåsen skole","H",511,140,651
"0301","Oslo","1201","Ellingsrudåsen skole","FRP",193,78,271
"0301","Oslo","1201","Ellingsrudåsen skole","DEMN",3,2,5
"0301","Oslo","1201","Ellingsrudåsen skole","DLF",1,0,1
"0301","Oslo","1201","Ellingsrudåsen skole","KSP",6,2,8
"0301","Oslo","1201","Ellingsrudåsen skole","MDG",19,5,24
"0301","Oslo","1201","Ellingsrudåsen skole","NKP",2,3,5
"0301","Oslo","1201","Ellingsrudåsen skole","PP",23,11,34
"0301","Oslo","1202","Gran skole","A",1054,598,1652
"0301","Oslo","1202","Gran skole","SV",106,50,156
"0301","Oslo","1202","Gran skole","RØDT",45,24,69
"0301","Oslo","1202","Gran skole","SP",4,9,13
"0301","Oslo","1202","Gran skole","KRF",42,26,68
"0301","Oslo","1202","Gran skole","V",46,15,61
"0301","Oslo","1202","Gran skole","H",354,158,512
"0301","Oslo","1202","Gran skole","FRP",169,120,289
"0301","Oslo","1202","Gran skole","DEMN",4,4,8
"0301","Oslo","1202","Gran skole","KSP",4,1,5
"0301","Oslo","1202","Gran skole","MDG",15,12,27
"0301","Oslo","1202","Gran skole","NKP",4,0,4
"0301","Oslo","1202","Gran skole","PP",18,8,26
"0301","Oslo","1203","Furuset skole","A",302,228,530
"0301","Oslo","1203","Furuset skole","SV",35,21,56
"0301","Oslo","1203","Furuset skole","RØDT",22,14,36
"0301","Oslo","1203","Furuset skole","SP",4,6,10
"0301","Oslo","1203","Furuset skole","KRF",12,6,18
"0301","Oslo","1203","Furuset skole","V",18,9,27
"0301","Oslo","1203","Furuset skole","H",186,64,250
"0301","Oslo","1203","Furuset skole","FRP",69,40,109
"0301","Oslo","1203","Furuset skole","DLF",1,0,1
"0301","Oslo","1203","Furuset skole","KYST",1,0,1
"0301","Oslo","1203","Furuset skole","MDG",4,1,5
"0301","Oslo","1203","Furuset skole","PP",2,3,5
"0301","Oslo","1204","Lindeberg skole","A",1187,491,1678
"0301","Oslo","1204","Lindeberg skole","SV",163,43,206
"0301","Oslo","1204","Lindeberg skole","RØDT",61,20,81
"0301","Oslo","1204","Lindeberg skole","SP",9,9,18
"0301","Oslo","1204","Lindeberg skole","KRF",53,15,68
"0301","Oslo","1204","Lindeberg skole","V",94,27,121
"0301","Oslo","1204","Lindeberg skole","H",440,148,588
"0301","Oslo","1204","Lindeberg skole","FRP",195,71,266
"0301","Oslo","1204","Lindeberg skole","DEMN",5,1,6
"0301","Oslo","1204","Lindeberg skole","DLF",1,0,1
"0301","Oslo","1204","Lindeberg skole","KSP",3,1,4
"0301","Oslo","1204","Lindeberg skole","KYST",3,0,3
"0301","Oslo","1204","Lindeberg skole","MDG",24,4,28
"0301","Oslo","1204","Lindeberg skole","NKP",1,0,1
"0301","Oslo","1204","Lindeberg skole","PP",10,5,15
"0301","Oslo","1205","Haugerudhallen","A",1108,661,1769
"0301","Oslo","1205","Haugerudhallen","SV",131,69,200
"0301","Oslo","1205","Haugerudhallen","RØDT",68,23,91
"0301","Oslo","1205","Haugerudhallen","SP",12,19,31
"0301","Oslo","1205","Haugerudhallen","KRF",57,40,97
"0301","Oslo","1205","Haugerudhallen","V",102,37,139
"0301","Oslo","1205","Haugerudhallen","H",482,270,752
"0301","Oslo","1205","Haugerudhallen","FRP",195,172,367
"0301","Oslo","1205","Haugerudhallen","DEMN",4,0,4
"0301","Oslo","1205","Haugerudhallen","KSP",2,2,4
"0301","Oslo","1205","Haugerudhallen","KYST",3,1,4
"0301","Oslo","1205","Haugerudhallen","MDG",28,16,44
"0301","Oslo","1205","Haugerudhallen","NKP",2,1,3
"0301","Oslo","1205","Haugerudhallen","PP",11,15,26
"0301","Oslo","1206","Hellerud videregående skole","A",945,846,1791
"0301","Oslo","1206","Hellerud videregående skole","SV",114,55,169
"0301","Oslo","1206","Hellerud videregående skole","RØDT",75,47,122
"0301","Oslo","1206","Hellerud videregående skole","SP",10,7,17
"0301","Oslo","1206","Hellerud videregående skole","KRF",58,40,98
"0301","Oslo","1206","Hellerud videregående skole","V",130,68,198
"0301","Oslo","1206","Hellerud videregående skole","H",730,496,1226
"0301","Oslo","1206","Hellerud videregående skole","FRP",260,250,510
"0301","Oslo","1206","Hellerud videregående skole","DEMN",1,1,2
"0301","Oslo","1206","Hellerud videregående skole","DLF",1,2,3
"0301","Oslo","1206","Hellerud videregående skole","KSP",0,2,2
"0301","Oslo","1206","Hellerud videregående skole","KYST",2,1,3
"0301","Oslo","1206","Hellerud videregående skole","MDG",37,22,59
"0301","Oslo","1206","Hellerud videregående skole","NKP",1,3,4
"0301","Oslo","1206","Hellerud videregående skole","PP",8,19,27
"0301","Oslo","1207","Bryn skole","A",785,311,1096
"0301","Oslo","1207","Bryn skole","SV",88,26,114
"0301","Oslo","1207","Bryn skole","RØDT",58,20,78
"0301","Oslo","1207","Bryn skole","SP",13,3,16
"0301","Oslo","1207","Bryn skole","KRF",72,38,110
"0301","Oslo","1207","Bryn skole","V",98,28,126
"0301","Oslo","1207","Bryn skole","H",441,154,595
"0301","Oslo","1207","Bryn skole","FRP",179,58,237
"0301","Oslo","1207","Bryn skole","DEMN",0,2,2
"0301","Oslo","1207","Bryn skole","KSP",3,0,3
"0301","Oslo","1207","Bryn skole","KYST",1,1,2
"0301","Oslo","1207","Bryn skole","MDG",19,8,27
"0301","Oslo","1207","Bryn skole","NKP",2,0,2
"0301","Oslo","1207","Bryn skole","PP",5,3,8
"0301","Oslo","1301","Godlia skole","A",492,297,789
"0301","Oslo","1301","Godlia skole","SV",98,38,136
"0301","Oslo","1301","Godlia skole","RØDT",40,18,58
"0301","Oslo","1301","Godlia skole","SP",4,4,8
"0301","Oslo","1301","Godlia skole","KRF",39,21,60
"0301","Oslo","1301","Godlia skole","V",97,35,132
"0301","Oslo","1301","Godlia skole","H",418,205,623
"0301","Oslo","1301","Godlia skole","FRP",110,68,178
"0301","Oslo","1301","Godlia skole","MDG",13,15,28
"0301","Oslo","1301","Godlia skole","NKP",1,0,1
"0301","Oslo","1301","Godlia skole","PP",3,0,3
"0301","Oslo","1302","Trasop skole","A",419,148,567
"0301","Oslo","1302","Trasop skole","SV",57,25,82
"0301","Oslo","1302","Trasop skole","RØDT",38,13,51
"0301","Oslo","1302","Trasop skole","SP",1,0,1
"0301","Oslo","1302","Trasop skole","KRF",28,5,33
"0301","Oslo","1302","Trasop skole","V",67,9,76
"0301","Oslo","1302","Trasop skole","H",313,84,397
"0301","Oslo","1302","Trasop skole","FRP",91,35,126
"0301","Oslo","1302","Trasop skole","DLF",1,0,1
"0301","Oslo","1302","Trasop skole","MDG",18,3,21
"0301","Oslo","1302","Trasop skole","NKP",2,0,2
"0301","Oslo","1302","Trasop skole","PP",2,1,3
"0301","Oslo","1303","Oppsal skole","A",890,328,1218
"0301","Oslo","1303","Oppsal skole","SV",173,45,218
"0301","Oslo","1303","Oppsal skole","RØDT",52,37,89
"0301","Oslo","1303","Oppsal skole","SP",12,8,20
"0301","Oslo","1303","Oppsal skole","KRF",77,24,101
"0301","Oslo","1303","Oppsal skole","V",189,40,229
"0301","Oslo","1303","Oppsal skole","H",693,178,871
"0301","Oslo","1303","Oppsal skole","FRP",186,71,257
"0301","Oslo","1303","Oppsal skole","DEMN",1,0,1
"0301","Oslo","1303","Oppsal skole","KSP",3,0,3
"0301","Oslo","1303","Oppsal skole","KYST",2,0,2
"0301","Oslo","1303","Oppsal skole","MDG",58,17,75
"0301","Oslo","1303","Oppsal skole","NKP",3,1,4
"0301","Oslo","1303","Oppsal skole","PP",14,8,22
"0301","Oslo","1304","Skøyenåsen skole","A",361,142,503
"0301","Oslo","1304","Skøyenåsen skole","SV",48,19,67
"0301","Oslo","1304","Skøyenåsen skole","RØDT",16,7,23
"0301","Oslo","1304","Skøyenåsen skole","SP",11,0,11
"0301","Oslo","1304","Skøyenåsen skole","KRF",31,12,43
"0301","Oslo","1304","Skøyenåsen skole","V",43,19,62
"0301","Oslo","1304","Skøyenåsen skole","H",303,99,402
"0301","Oslo","1304","Skøyenåsen skole","FRP",84,48,132
"0301","Oslo","1304","Skøyenåsen skole","DEMN",1,0,1
"0301","Oslo","1304","Skøyenåsen skole","KSP",0,1,1
"0301","Oslo","1304","Skøyenåsen skole","MDG",9,8,17
"0301","Oslo","1304","Skøyenåsen skole","PP",0,3,3
"0301","Oslo","1305","Østensjø skole","A",310,168,478
"0301","Oslo","1305","Østensjø skole","SV",75,26,101
"0301","Oslo","1305","Østensjø skole","RØDT",26,10,36
"0301","Oslo","1305","Østensjø skole","SP",6,1,7
"0301","Oslo","1305","Østensjø skole","KRF",51,29,80
"0301","Oslo","1305","Østensjø skole","V",81,21,102
"0301","Oslo","1305","Østensjø skole","H",463,216,679
"0301","Oslo","1305","Østensjø skole","FRP",77,63,140
"0301","Oslo","1305","Østensjø skole","DLF",2,0,2
"0301","Oslo","1305","Østensjø skole","KSP",2,0,2
"0301","Oslo","1305","Østensjø skole","KYST",0,1,1
"0301","Oslo","1305","Østensjø skole","MDG",18,3,21
"0301","Oslo","1305","Østensjø skole","PP",2,2,4
"0301","Oslo","1306","Manglerud videregående skole","A",918,312,1230
"0301","Oslo","1306","Manglerud videregående skole","SV",85,21,106
"0301","Oslo","1306","Manglerud videregående skole","RØDT",37,25,62
"0301","Oslo","1306","Manglerud videregående skole","SP",8,4,12
"0301","Oslo","1306","Manglerud videregående skole","KRF",68,16,84
"0301","Oslo","1306","Manglerud videregående skole","V",113,34,147
"0301","Oslo","1306","Manglerud videregående skole","H",725,169,894
"0301","Oslo","1306","Manglerud videregående skole","FRP",199,73,272
"0301","Oslo","1306","Manglerud videregående skole","DEMN",6,0,6
"0301","Oslo","1306","Manglerud videregående skole","DLF",1,0,1
"0301","Oslo","1306","Manglerud videregående skole","KSP",2,0,2
"0301","Oslo","1306","Manglerud videregående skole","KYST",0,1,1
"0301","Oslo","1306","Manglerud videregående skole","MDG",23,3,26
"0301","Oslo","1306","Manglerud videregående skole","NKP",0,3,3
"0301","Oslo","1306","Manglerud videregående skole","PP",13,12,25
"0301","Oslo","1307","Høyenhall skole","A",625,174,799
"0301","Oslo","1307","Høyenhall skole","SV",98,23,121
"0301","Oslo","1307","Høyenhall skole","RØDT",57,16,73
"0301","Oslo","1307","Høyenhall skole","SP",8,0,8
"0301","Oslo","1307","Høyenhall skole","KRF",39,16,55
"0301","Oslo","1307","Høyenhall skole","V",109,20,129
"0301","Oslo","1307","Høyenhall skole","H",629,199,828
"0301","Oslo","1307","Høyenhall skole","FRP",183,69,252
"0301","Oslo","1307","Høyenhall skole","DEMN",1,1,2
"0301","Oslo","1307","Høyenhall skole","DLF",1,0,1
"0301","Oslo","1307","Høyenhall skole","KSP",2,0,2
"0301","Oslo","1307","Høyenhall skole","KYST",1,1,2
"0301","Oslo","1307","Høyenhall skole","MDG",17,2,19
"0301","Oslo","1307","Høyenhall skole","NKP",0,1,1
"0301","Oslo","1307","Høyenhall skole","PP",7,2,9
"0301","Oslo","1308","Abildsø skole","A",483,139,622
"0301","Oslo","1308","Abildsø skole","SV",80,14,94
"0301","Oslo","1308","Abildsø skole","RØDT",38,19,57
"0301","Oslo","1308","Abildsø skole","SP",8,2,10
"0301","Oslo","1308","Abildsø skole","KRF",42,8,50
"0301","Oslo","1308","Abildsø skole","V",86,12,98
"0301","Oslo","1308","Abildsø skole","H",561,115,676
"0301","Oslo","1308","Abildsø skole","FRP",120,42,162
"0301","Oslo","1308","Abildsø skole","DEMN",1,0,1
"0301","Oslo","1308","Abildsø skole","KSP",1,0,1
"0301","Oslo","1308","Abildsø skole","MDG",13,5,18
"0301","Oslo","1308","Abildsø skole","NKP",0,1,1
"0301","Oslo","1308","Abildsø skole","PP",7,2,9
"0301","Oslo","1309","Ulsrud videregående skole","A",971,875,1846
"0301","Oslo","1309","Ulsrud videregående skole","SV",176,106,282
"0301","Oslo","1309","Ulsrud videregående skole","RØDT",76,54,130
"0301","Oslo","1309","Ulsrud videregående skole","SP",9,10,19
"0301","Oslo","1309","Ulsrud videregående skole","KRF",76,48,124
"0301","Oslo","1309","Ulsrud videregående skole","V",141,86,227
"0301","Oslo","1309","Ulsrud videregående skole","H",668,449,1117
"0301","Oslo","1309","Ulsrud videregående skole","FRP",185,193,378
"0301","Oslo","1309","Ulsrud videregående skole","DEMN",2,0,2
"0301","Oslo","1309","Ulsrud videregående skole","DLF",3,2,5
"0301","Oslo","1309","Ulsrud videregående skole","KSP",2,0,2
"0301","Oslo","1309","Ulsrud videregående skole","KYST",1,0,1
"0301","Oslo","1309","Ulsrud videregående skole","MDG",42,29,71
"0301","Oslo","1309","Ulsrud videregående skole","NKP",3,1,4
"0301","Oslo","1309","Ulsrud videregående skole","PP",10,15,25
"0301","Oslo","1310","Rustad skole","A",968,415,1383
"0301","Oslo","1310","Rustad skole","SV",131,38,169
"0301","Oslo","1310","Rustad skole","RØDT",66,20,86
"0301","Oslo","1310","Rustad skole","SP",18,9,27
"0301","Oslo","1310","Rustad skole","KRF",53,14,67
"0301","Oslo","1310","Rustad skole","V",99,35,134
"0301","Oslo","1310","Rustad skole","H",630,273,903
"0301","Oslo","1310","Rustad skole","FRP",179,121,300
"0301","Oslo","1310","Rustad skole","DEMN",2,0,2
"0301","Oslo","1310","Rustad skole","DLF",1,1,2
"0301","Oslo","1310","Rustad skole","KSP",1,2,3
"0301","Oslo","1310","Rustad skole","MDG",31,16,47
"0301","Oslo","1310","Rustad skole","NKP",2,1,3
"0301","Oslo","1310","Rustad skole","PP",12,6,18
"0301","Oslo","1401","Ekeberg skole","A",668,222,890
"0301","Oslo","1401","Ekeberg skole","SV",117,25,142
"0301","Oslo","1401","Ekeberg skole","RØDT",75,22,97
"0301","Oslo","1401","Ekeberg skole","SP",6,3,9
"0301","Oslo","1401","Ekeberg skole","KRF",108,27,135
"0301","Oslo","1401","Ekeberg skole","V",182,32,214
"0301","Oslo","1401","Ekeberg skole","H",897,231,1128
"0301","Oslo","1401","Ekeberg skole","FRP",163,58,221
"0301","Oslo","1401","Ekeberg skole","DEMN",2,0,2
"0301","Oslo","1401","Ekeberg skole","KSP",2,1,3
"0301","Oslo","1401","Ekeberg skole","MDG",36,19,55
"0301","Oslo","1401","Ekeberg skole","NKP",0,1,1
"0301","Oslo","1401","Ekeberg skole","PP",10,4,14
"0301","Oslo","1402","Bekkelaget skole","A",754,310,1064
"0301","Oslo","1402","Bekkelaget skole","SV",125,41,166
"0301","Oslo","1402","Bekkelaget skole","RØDT",45,31,76
"0301","Oslo","1402","Bekkelaget skole","SP",6,4,10
"0301","Oslo","1402","Bekkelaget skole","KRF",137,33,170
"0301","Oslo","1402","Bekkelaget skole","V",351,97,448
"0301","Oslo","1402","Bekkelaget skole","H",1707,627,2334
"0301","Oslo","1402","Bekkelaget skole","FRP",259,125,384
"0301","Oslo","1402","Bekkelaget skole","DEMN",1,2,3
"0301","Oslo","1402","Bekkelaget skole","DLF",1,0,1
"0301","Oslo","1402","Bekkelaget skole","KSP",4,0,4
"0301","Oslo","1402","Bekkelaget skole","KYST",1,1,2
"0301","Oslo","1402","Bekkelaget skole","MDG",47,15,62
"0301","Oslo","1402","Bekkelaget skole","PP",3,0,3
"0301","Oslo","1403","Nedre Bekkelaget skole","A",182,50,232
"0301","Oslo","1403","Nedre Bekkelaget skole","SV",35,8,43
"0301","Oslo","1403","Nedre Bekkelaget skole","RØDT",19,10,29
"0301","Oslo","1403","Nedre Bekkelaget skole","KRF",15,1,16
"0301","Oslo","1403","Nedre Bekkelaget skole","V",62,19,81
"0301","Oslo","1403","Nedre Bekkelaget skole","H",563,152,715
"0301","Oslo","1403","Nedre Bekkelaget skole","FRP",89,35,124
"0301","Oslo","1403","Nedre Bekkelaget skole","DLF",1,0,1
"0301","Oslo","1403","Nedre Bekkelaget skole","KYST",1,1,2
"0301","Oslo","1403","Nedre Bekkelaget skole","MDG",32,3,35
"0301","Oslo","1403","Nedre Bekkelaget skole","PP",1,2,3
"0301","Oslo","1404","Lambertseter videregående skole","A",426,280,706
"0301","Oslo","1404","Lambertseter videregående skole","SV",36,32,68
"0301","Oslo","1404","Lambertseter videregående skole","RØDT",18,23,41
"0301","Oslo","1404","Lambertseter videregående skole","SP",8,2,10
"0301","Oslo","1404","Lambertseter videregående skole","KRF",37,19,56
"0301","Oslo","1404","Lambertseter videregående skole","V",67,40,107
"0301","Oslo","1404","Lambertseter videregående skole","H",497,264,761
"0301","Oslo","1404","Lambertseter videregående skole","FRP",132,81,213
"0301","Oslo","1404","Lambertseter videregående skole","DEMN",1,2,3
"0301","Oslo","1404","Lambertseter videregående skole","DLF",2,0,2
"0301","Oslo","1404","Lambertseter videregående skole","KSP",2,0,2
"0301","Oslo","1404","Lambertseter videregående skole","KYST",1,0,1
"0301","Oslo","1404","Lambertseter videregående skole","MDG",23,8,31
"0301","Oslo","1404","Lambertseter videregående skole","NKP",1,1,2
"0301","Oslo","1404","Lambertseter videregående skole","PP",4,7,11
"0301","Oslo","1405","Lambertseter skole","A",920,523,1443
"0301","Oslo","1405","Lambertseter skole","SV",108,72,180
"0301","Oslo","1405","Lambertseter skole","RØDT",70,33,103
"0301","Oslo","1405","Lambertseter skole","SP",9,12,21
"0301","Oslo","1405","Lambertseter skole","KRF",62,35,97
"0301","Oslo","1405","Lambertseter skole","V",138,60,198
"0301","Oslo","1405","Lambertseter skole","H",688,313,1001
"0301","Oslo","1405","Lambertseter skole","FRP",248,111,359
"0301","Oslo","1405","Lambertseter skole","DEMN",2,2,4
"0301","Oslo","1405","Lambertseter skole","DLF",3,0,3
"0301","Oslo","1405","Lambertseter skole","KSP",1,0,1
"0301","Oslo","1405","Lambertseter skole","KYST",1,0,1
"0301","Oslo","1405","Lambertseter skole","MDG",35,13,48
"0301","Oslo","1405","Lambertseter skole","NKP",1,1,2
"0301","Oslo","1405","Lambertseter skole","PP",15,10,25
"0301","Oslo","1406","Nordseter skole","A",563,262,825
"0301","Oslo","1406","Nordseter skole","SV",85,23,108
"0301","Oslo","1406","Nordseter skole","RØDT",48,11,59
"0301","Oslo","1406","Nordseter skole","SP",6,0,6
"0301","Oslo","1406","Nordseter skole","KRF",99,31,130
"0301","Oslo","1406","Nordseter skole","V",151,48,199
"0301","Oslo","1406","Nordseter skole","H",1395,449,1844
"0301","Oslo","1406","Nordseter skole","FRP",264,64,328
"0301","Oslo","1406","Nordseter skole","DEMN",0,1,1
"0301","Oslo","1406","Nordseter skole","DLF",3,0,3
"0301","Oslo","1406","Nordseter skole","KSP",3,1,4
"0301","Oslo","1406","Nordseter skole","KYST",1,0,1
"0301","Oslo","1406","Nordseter skole","MDG",36,11,47
"0301","Oslo","1406","Nordseter skole","PP",10,7,17
"0301","Oslo","1407","Nordstrand skole","A",289,89,378
"0301","Oslo","1407","Nordstrand skole","SV",48,24,72
"0301","Oslo","1407","Nordstrand skole","RØDT",26,13,39
"0301","Oslo","1407","Nordstrand skole","SP",3,2,5
"0301","Oslo","1407","Nordstrand skole","KRF",74,24,98
"0301","Oslo","1407","Nordstrand skole","V",134,36,170
"0301","Oslo","1407","Nordstrand skole","H",1043,296,1339
"0301","Oslo","1407","Nordstrand skole","FRP",113,48,161
"0301","Oslo","1407","Nordstrand skole","DLF",2,0,2
"0301","Oslo","1407","Nordstrand skole","KSP",2,0,2
"0301","Oslo","1407","Nordstrand skole","KYST",0,1,1
"0301","Oslo","1407","Nordstrand skole","MDG",23,12,35
"0301","Oslo","1407","Nordstrand skole","PP",0,1,1
"0301","Oslo","1408","Munkerud skole","A",551,191,742
"0301","Oslo","1408","Munkerud skole","SV",71,38,109
"0301","Oslo","1408","Munkerud skole","RØDT",37,15,52
"0301","Oslo","1408","Munkerud skole","SP",6,0,6
"0301","Oslo","1408","Munkerud skole","KRF",100,39,139
"0301","Oslo","1408","Munkerud skole","V",164,35,199
"0301","Oslo","1408","Munkerud skole","H",1128,277,1405
"0301","Oslo","1408","Munkerud skole","FRP",152,42,194
"0301","Oslo","1408","Munkerud skole","DEMN",1,0,1
"0301","Oslo","1408","Munkerud skole","DLF",0,1,1
"0301","Oslo","1408","Munkerud skole","KSP",1,0,1
"0301","Oslo","1408","Munkerud skole","KYST",2,0,2
"0301","Oslo","1408","Munkerud skole","MDG",32,8,40
"0301","Oslo","1408","Munkerud skole","PP",3,1,4
"0301","Oslo","1409","Ljan skole","A",307,70,377
"0301","Oslo","1409","Ljan skole","SV",76,17,93
"0301","Oslo","1409","Ljan skole","RØDT",39,8,47
"0301","Oslo","1409","Ljan skole","SP",4,2,6
"0301","Oslo","1409","Ljan skole","KRF",46,14,60
"0301","Oslo","1409","Ljan skole","V",122,21,143
"0301","Oslo","1409","Ljan skole","H",937,192,1129
"0301","Oslo","1409","Ljan skole","FRP",105,47,152
"0301","Oslo","1409","Ljan skole","DEMN",2,0,2
"0301","Oslo","1409","Ljan skole","DLF",0,1,1
"0301","Oslo","1409","Ljan skole","KSP",0,1,1
"0301","Oslo","1409","Ljan skole","KYST",1,1,2
"0301","Oslo","1409","Ljan skole","MDG",17,12,29
"0301","Oslo","1409","Ljan skole","PP",2,1,3
"0301","Oslo","1501","Hallagerbakken skole","A",744,315,1059
"0301","Oslo","1501","Hallagerbakken skole","SV",125,61,186
"0301","Oslo","1501","Hallagerbakken skole","RØDT",54,40,94
"0301","Oslo","1501","Hallagerbakken skole","SP",2,5,7
"0301","Oslo","1501","Hallagerbakken skole","KRF",64,32,96
"0301","Oslo","1501","Hallagerbakken skole","V",97,42,139
"0301","Oslo","1501","Hallagerbakken skole","H",372,176,548
"0301","Oslo","1501","Hallagerbakken skole","FRP",118,63,181
"0301","Oslo","1501","Hallagerbakken skole","DEMN",2,0,2
"0301","Oslo","1501","Hallagerbakken skole","DLF",0,2,2
"0301","Oslo","1501","Hallagerbakken skole","KSP",4,0,4
"0301","Oslo","1501","Hallagerbakken skole","MDG",49,12,61
"0301","Oslo","1501","Hallagerbakken skole","NKP",1,0,1
"0301","Oslo","1501","Hallagerbakken skole","PP",4,4,8
"0301","Oslo","1502","Rosenholm skole","A",816,286,1102
"0301","Oslo","1502","Rosenholm skole","SV",117,41,158
"0301","Oslo","1502","Rosenholm skole","RØDT",50,25,75
"0301","Oslo","1502","Rosenholm skole","SP",9,4,13
"0301","Oslo","1502","Rosenholm skole","KRF",30,16,46
"0301","Oslo","1502","Rosenholm skole","V",65,24,89
"0301","Oslo","1502","Rosenholm skole","H",260,68,328
"0301","Oslo","1502","Rosenholm skole","FRP",110,39,149
"0301","Oslo","1502","Rosenholm skole","DEMN",2,1,3
"0301","Oslo","1502","Rosenholm skole","DLF",1,2,3
"0301","Oslo","1502","Rosenholm skole","KSP",8,0,8
"0301","Oslo","1502","Rosenholm skole","MDG",30,14,44
"0301","Oslo","1502","Rosenholm skole","PP",9,0,9
"0301","Oslo","1503","Toppåsen skole","A",569,377,946
"0301","Oslo","1503","Toppåsen skole","SV",51,28,79
"0301","Oslo","1503","Toppåsen skole","RØDT",22,12,34
"0301","Oslo","1503","Toppåsen skole","SP",3,4,7
"0301","Oslo","1503","Toppåsen skole","KRF",38,16,54
"0301","Oslo","1503","Toppåsen skole","V",70,28,98
"0301","Oslo","1503","Toppåsen skole","H",371,122,493
"0301","Oslo","1503","Toppåsen skole","FRP",93,41,134
"0301","Oslo","1503","Toppåsen skole","DEMN",0,2,2
"0301","Oslo","1503","Toppåsen skole","KSP",3,0,3
"0301","Oslo","1503","Toppåsen skole","KYST",2,0,2
"0301","Oslo","1503","Toppåsen skole","MDG",21,12,33
"0301","Oslo","1503","Toppåsen skole","NKP",0,1,1
"0301","Oslo","1503","Toppåsen skole","PP",5,6,11
"0301","Oslo","1504","Prinsdal skole","A",605,249,854
"0301","Oslo","1504","Prinsdal skole","SV",118,36,154
"0301","Oslo","1504","Prinsdal skole","RØDT",42,17,59
"0301","Oslo","1504","Prinsdal skole","SP",7,5,12
"0301","Oslo","1504","Prinsdal skole","KRF",59,20,79
"0301","Oslo","1504","Prinsdal skole","V",84,20,104
"0301","Oslo","1504","Prinsdal skole","H",438,114,552
"0301","Oslo","1504","Prinsdal skole","FRP",152,42,194
"0301","Oslo","1504","Prinsdal skole","DEMN",1,2,3
"0301","Oslo","1504","Prinsdal skole","DLF",0,1,1
"0301","Oslo","1504","Prinsdal skole","KSP",1,2,3
"0301","Oslo","1504","Prinsdal skole","KYST",1,1,2
"0301","Oslo","1504","Prinsdal skole","MDG",27,10,37
"0301","Oslo","1504","Prinsdal skole","NKP",3,0,3
"0301","Oslo","1504","Prinsdal skole","PP",2,3,5
"0301","Oslo","1505","Mortensrud skole","A",1072,492,1564
"0301","Oslo","1505","Mortensrud skole","SV",157,40,197
"0301","Oslo","1505","Mortensrud skole","RØDT",59,17,76
"0301","Oslo","1505","Mortensrud skole","SP",7,17,24
"0301","Oslo","1505","Mortensrud skole","KRF",84,18,102
"0301","Oslo","1505","Mortensrud skole","V",114,43,157
"0301","Oslo","1505","Mortensrud skole","H",487,211,698
"0301","Oslo","1505","Mortensrud skole","FRP",140,69,209
"0301","Oslo","1505","Mortensrud skole","DEMN",1,0,1
"0301","Oslo","1505","Mortensrud skole","DLF",4,0,4
"0301","Oslo","1505","Mortensrud skole","KSP",3,0,3
"0301","Oslo","1505","Mortensrud skole","KYST",1,0,1
"0301","Oslo","1505","Mortensrud skole","MDG",29,13,42
"0301","Oslo","1505","Mortensrud skole","NKP",4,0,4
"0301","Oslo","1505","Mortensrud skole","PP",6,4,10
"0301","Oslo","1506","Klemetsrud skole","A",361,149,510
"0301","Oslo","1506","Klemetsrud skole","SV",39,8,47
"0301","Oslo","1506","Klemetsrud skole","RØDT",16,4,20
"0301","Oslo","1506","Klemetsrud skole","SP",5,2,7
"0301","Oslo","1506","Klemetsrud skole","KRF",37,8,45
"0301","Oslo","1506","Klemetsrud skole","V",34,12,46
"0301","Oslo","1506","Klemetsrud skole","H",316,77,393
"0301","Oslo","1506","Klemetsrud skole","FRP",124,34,158
"0301","Oslo","1506","Klemetsrud skole","DEMN",1,2,3
"0301","Oslo","1506","Klemetsrud skole","KSP",0,1,1
"0301","Oslo","1506","Klemetsrud skole","MDG",6,3,9
"0301","Oslo","1506","Klemetsrud skole","PP",6,1,7
"0301","Oslo","1507","Bjørndal skole","A",992,296,1288
"0301","Oslo","1507","Bjørndal skole","SV",118,28,146
"0301","Oslo","1507","Bjørndal skole","RØDT",48,13,61
"0301","Oslo","1507","Bjørndal skole","SP",3,7,10
"0301","Oslo","1507","Bjørndal skole","KRF",67,10,77
"0301","Oslo","1507","Bjørndal skole","V",59,15,74
"0301","Oslo","1507","Bjørndal skole","H",628,100,728
"0301","Oslo","1507","Bjørndal skole","FRP",165,40,205
"0301","Oslo","1507","Bjørndal skole","DEMN",3,1,4
"0301","Oslo","1507","Bjørndal skole","DLF",0,2,2
"0301","Oslo","1507","Bjørndal skole","KSP",5,0,5
"0301","Oslo","1507","Bjørndal skole","MDG",15,7,22
"0301","Oslo","1507","Bjørndal skole","NKP",1,1,2
"0301","Oslo","1507","Bjørndal skole","PP",3,1,4
"0301","Oslo","1601","Rådhuset","A",28,45,73
"0301","Oslo","1601","Rådhuset","SV",9,10,19
"0301","Oslo","1601","Rådhuset","RØDT",8,4,12
"0301","Oslo","1601","Rådhuset","SP",0,3,3
"0301","Oslo","1601","Rådhuset","KRF",7,6,13
"0301","Oslo","1601","Rådhuset","V",11,13,24
"0301","Oslo","1601","Rådhuset","H",47,44,91
"0301","Oslo","1601","Rådhuset","FRP",7,13,20
"0301","Oslo","1601","Rådhuset","KYST",0,1,1
"0301","Oslo","1601","Rådhuset","MDG",3,7,10
"0301","Oslo","1601","Rådhuset","PP",1,0,1
"0301","Oslo","1701","Sørkedalen skole","A",104,16,120
"0301","Oslo","1701","Sørkedalen skole","SV",9,1,10
"0301","Oslo","1701","Sørkedalen skole","RØDT",16,4,20
"0301","Oslo","1701","Sørkedalen skole","SP",3,1,4
"0301","Oslo","1701","Sørkedalen skole","KRF",4,0,4
"0301","Oslo","1701","Sørkedalen skole","V",23,2,25
"0301","Oslo","1701","Sørkedalen skole","H",120,29,149
"0301","Oslo","1701","Sørkedalen skole","FRP",20,8,28
"0301","Oslo","1701","Sørkedalen skole","KSP",1,0,1
"0301","Oslo","1701","Sørkedalen skole","MDG",8,5,13
"0301","Oslo","1701","Sørkedalen skole","PP",2,2,4
"0301","Oslo","1702","Maridalen skole","A",98,17,115
"0301","Oslo","1702","Maridalen skole","SV",16,6,22
"0301","Oslo","1702","Maridalen skole","RØDT",11,3,14
"0301","Oslo","1702","Maridalen skole","SP",5,2,7
"0301","Oslo","1702","Maridalen skole","KRF",3,0,3
"0301","Oslo","1702","Maridalen skole","V",39,5,44
"0301","Oslo","1702","Maridalen skole","H",76,14,90
"0301","Oslo","1702","Maridalen skole","FRP",27,9,36
"0301","Oslo","1702","Maridalen skole","DEMN",1,0,1
"0301","Oslo","1702","Maridalen skole","MDG",3,4,7
"0301","Oslo","1702","Maridalen skole","PP",1,0,1
"0402","Kongsvinger","0000",,"A",2077,714,2791
"0402","Kongsvinger","0000",,"SV",243,96,339
"0402","Kongsvinger","0000",,"SP",333,68,401
"0402","Kongsvinger","0000",,"KRF",142,48,190
"0402","Kongsvinger","0000",,"V",350,78,428
"0402","Kongsvinger","0000",,"H",1096,311,1407
"0402","Kongsvinger","0000",,"FRP",811,320,1131
"0402","Kongsvinger","0000",,"PP",842,314,1156
"0403","Hamar","0000",,"A",4153,1693,5846
"0403","Hamar","0000",,"SV",373,197,570
"0403","Hamar","0000",,"RØDT",83,50,133
"0403","Hamar","0000",,"SP",216,65,281
"0403","Hamar","0000",,"KRF",714,183,897
"0403","Hamar","0000",,"V",532,167,699
"0403","Hamar","0000",,"H",2243,734,2977
"0403","Hamar","0000",,"FRP",445,188,633
"0403","Hamar","0000",,"MDG",125,48,173
"0403","Hamar","0000",,"PP",417,280,697
"0403","Hamar","0000",,"BBL",2128,718,2846
"0412","Ringsaker","0000",,"A",5760,1850,7610
"0412","Ringsaker","0000",,"SV",296,121,417
"0412","Ringsaker","0000",,"SP",965,203,1168
"0412","Ringsaker","0000",,"KRF",282,129,411
"0412","Ringsaker","0000",,"V",576,183,759
"0412","Ringsaker","0000",,"H",1663,442,2105
"0412","Ringsaker","0000",,"FRP",662,211,873
"0412","Ringsaker","0000",,"MDG",101,56,157
"0412","Ringsaker","0000",,"PP",226,112,338
"0412","Ringsaker","0000",,"RSL",1112,158,1270
"0415","Løten","0000",,"A",1573,316,1889
"0415","Løten","0000",,"SV",107,23,130
"0415","Løten","0000",,"SP",456,67,523
"0415","Løten","0000",,"KRF",112,22,134
"0415","Løten","0000",,"V",92,18,110
"0415","Løten","0000",,"H",355,67,422
"0415","Løten","0000",,"FRP",238,49,287
"0417","Stange","0000",,"A",4110,957,5067
"0417","Stange","0000",,"SV",257,62,319
"0417","Stange","0000",,"SP",592,116,708
"0417","Stange","0000",,"KRF",418,90,508
"0417","Stange","0000",,"V",417,89,506
"0417","Stange","0000",,"H",946,178,1124
"0417","Stange","0000",,"FRP",558,136,694
"0417","Stange","0000",,"MDG",122,38,160
"0417","Stange","0000",,"PP",177,50,227
"0417","Stange","0000",,"BLSTA",284,38,322
"0418","Nord-Odal","0000",,"A",1245,242,1487
"0418","Nord-Odal","0000",,"SV",116,20,136
"0418","Nord-Odal","0000",,"SP",206,41,247
"0418","Nord-Odal","0000",,"V",64,10,74
"0418","Nord-Odal","0000",,"H",264,54,318
"0418","Nord-Odal","0000",,"FRP",355,57,412
"0419","Sør-Odal","0000",,"A",1171,212,1383
"0419","Sør-Odal","0000",,"SV",208,19,227
"0419","Sør-Odal","0000",,"SP",445,67,512
"0419","Sør-Odal","0000",,"H",918,95,1013
"0419","Sør-Odal","0000",,"FRP",320,24,344
"0419","Sør-Odal","0000",,"PP",298,37,335
"0419","Sør-Odal","0000",,"KRF_V_SO",93,6,99
"0420","Eidskog","0000",,"A",859,220,1079
"0420","Eidskog","0000",,"SV",89,43,132
"0420","Eidskog","0000",,"SP",730,199,929
"0420","Eidskog","0000",,"V",85,30,115
"0420","Eidskog","0000",,"H",408,111,519
"0420","Eidskog","0000",,"FRP",185,77,262
"0420","Eidskog","0000",,"DEMN",17,5,22
"0423","Grue","0000",,"A",927,137,1064
"0423","Grue","0000",,"SV",68,12,80
"0423","Grue","0000",,"SP",292,52,344
"0423","Grue","0000",,"GRUEFL",733,114,847
"0425","Åsnes","0000",,"A",1143,309,1452
"0425","Åsnes","0000",,"SV",78,18,96
"0425","Åsnes","0000",,"SP",397,68,465
"0425","Åsnes","0000",,"V",380,71,451
"0425","Åsnes","0000",,"H",306,73,379
"0425","Åsnes","0000",,"FRP",315,72,387
"0425","Åsnes","0000",,"PP",98,43,141
"0425","Åsnes","0000",,"RADS",114,46,160
"0426","Våler","0000",,"A",826,209,1035
"0426","Våler","0000",,"SV",61,27,88
"0426","Våler","0000",,"SP",147,32,179
"0426","Våler","0000",,"V",154,47,201
"0426","Våler","0000",,"H",185,72,257
"0426","Våler","0000",,"FRP",116,42,158
"0426","Våler","0000",,"PP",122,21,143
"0426","Våler","0000",,"BYGVÅL",10,2,12
"0427","Elverum","0000",,"A",3054,747,3801
"0427","Elverum","0000",,"SV",231,82,313
"0427","Elverum","0000",,"SP",409,93,502
"0427","Elverum","0000",,"KRF",135,36,171
"0427","Elverum","0000",,"V",268,61,329
"0427","Elverum","0000",,"H",2836,650,3486
"0427","Elverum","0000",,"FRP",598,168,766
"0427","Elverum","0000",,"MDG",22,17,39
"0427","Elverum","0000",,"TE",258,38,296
"0428","Trysil","0000",,"A",1095,205,1300
"0428","Trysil","0000",,"SV",209,49,258
"0428","Trysil","0000",,"SP",530,72,602
"0428","Trysil","0000",,"KRF",138,34,172
"0428","Trysil","0000",,"V",113,26,139
"0428","Trysil","0000",,"H",661,141,802
"0428","Trysil","0000",,"FRP",223,59,282
"0429","Åmot","0000",,"A",473,145,618
"0429","Åmot","0000",,"SV",75,35,110
"0429","Åmot","0000",,"SP",608,112,720
"0429","Åmot","0000",,"V",60,7,67
"0429","Åmot","0000",,"H",179,66,245
"0429","Åmot","0000",,"FRP",139,49,188
"0429","Åmot","0000",,"PP",62,23,85
"0430","Stor-Elvdal","0000",,"A",512,130,642
"0430","Stor-Elvdal","0000",,"SV",27,19,46
"0430","Stor-Elvdal","0000",,"SP",108,28,136
"0430","Stor-Elvdal","0000",,"V",82,18,100
"0430","Stor-Elvdal","0000",,"H",140,56,196
"0430","Stor-Elvdal","0000",,"FRP",48,12,60
"0430","Stor-Elvdal","0000",,"BSE",225,80,305
"0432","Rendalen","0000",,"A",471,88,559
"0432","Rendalen","0000",,"SV",103,28,131
"0432","Rendalen","0000",,"SP",347,77,424
"0432","Rendalen","0000",,"H",79,18,97
"0434","Engerdal","0000",,"A",337,75,412
"0434","Engerdal","0000",,"H",82,19,101
"0434","Engerdal","0000",,"SP_V",269,64,333
"0436","Tolga","0000",,"A",167,25,192
"0436","Tolga","0000",,"SV",173,42,215
"0436","Tolga","0000",,"SP",334,45,379
"0436","Tolga","0000",,"V",70,19,89
"0436","Tolga","0000",,"TFV",32,5,37
"0437","Tynset","0000",,"A",362,260,622
"0437","Tynset","0000",,"SV",489,345,834
"0437","Tynset","0000",,"SP",409,222,631
"0437","Tynset","0000",,"KRF",54,37,91
"0437","Tynset","0000",,"V",65,40,105
"0437","Tynset","0000",,"H",192,146,338
"0437","Tynset","0000",,"FRP",42,38,80
"0437","Tynset","0000",,"TYV",99,38,137
"0438","Alvdal","0000",,"A",373,112,485
"0438","Alvdal","0000",,"SP",387,57,444
"0438","Alvdal","0000",,"KRF",62,13,75
"0438","Alvdal","0000",,"V",165,33,198
"0438","Alvdal","0000",,"FRP",58,8,66
"0439","Folldal","0000",,"A",343,93,436
"0439","Folldal","0000",,"SV",79,27,106
"0439","Folldal","0000",,"SP",366,67,433
"0441","Os","0000",,"A",242,67,309
"0441","Os","0000",,"SV",74,14,88
"0441","Os","0000",,"SP",573,110,683
"0501","Lillehammer","0000",,"A",3827,1377,5204
"0501","Lillehammer","0000",,"SV",447,189,636
"0501","Lillehammer","0000",,"RØDT",332,143,475
"0501","Lillehammer","0000",,"SP",591,103,694
"0501","Lillehammer","0000",,"KRF",330,88,418
"0501","Lillehammer","0000",,"V",1008,278,1286
"0501","Lillehammer","0000",,"H",2330,688,3018
"0501","Lillehammer","0000",,"FRP",553,173,726
"0501","Lillehammer","0000",,"MDG",215,68,283
"0501","Lillehammer","0000",,"PP",121,65,186
"0501","Lillehammer","0000",,"LILLEHL",140,29,169
"0502","Gjøvik","0000",,"A",4869,1129,5998
"0502","Gjøvik","0000",,"SV",292,120,412
"0502","Gjøvik","0000",,"RØDT",234,66,300
"0502","Gjøvik","0000",,"SP",876,99,975
"0502","Gjøvik","0000",,"KRF",500,127,627
"0502","Gjøvik","0000",,"V",673,128,801
"0502","Gjøvik","0000",,"H",2648,688,3336
"0502","Gjøvik","0000",,"FRP",576,158,734
"0502","Gjøvik","0000",,"MDG",111,34,145
"0502","Gjøvik","0000",,"PP",429,144,573
"0511","Dovre","0000",,"A",349,114,463
"0511","Dovre","0000",,"SP",542,135,677
"0511","Dovre","0000",,"H",114,24,138
"0511","Dovre","0000",,"FRP",69,9,78
"0512","Lesja","0000",,"A",379,112,491
"0512","Lesja","0000",,"SP",329,99,428
"0512","Lesja","0000",,"V",58,18,76
"0512","Lesja","0000",,"H",128,42,170
"0513","Skjåk","0000",,"A",348,138,486
"0513","Skjåk","0000",,"SP",430,136,566
"0513","Skjåk","0000",,"BS",94,50,144
"0514","Lom","0000",,"A",279,109,388
"0514","Lom","0000",,"SP",291,99,390
"0514","Lom","0000",,"BLLOM",125,72,197
"0514","Lom","0000",,"LOMSL",138,82,220
"0515","Vågå","0000",,"A",980,205,1185
"0515","Vågå","0000",,"SV",100,28,128
"0515","Vågå","0000",,"SP",246,42,288
"0515","Vågå","0000",,"FRP",44,5,49
"0515","Vågå","0000",,"BLTS",322,61,383
"0516","Nord-Fron","0000",,"A",947,205,1152
"0516","Nord-Fron","0000",,"SV",45,19,64
"0516","Nord-Fron","0000",,"SP",771,116,887
"0516","Nord-Fron","0000",,"KRF",91,19,110
"0516","Nord-Fron","0000",,"V",238,61,299
"0516","Nord-Fron","0000",,"H",316,49,365
"0516","Nord-Fron","0000",,"FRP",118,33,151
"0517","Sel","0000",,"A",1310,309,1619
"0517","Sel","0000",,"SV",103,30,133
"0517","Sel","0000",,"SP",239,63,302
"0517","Sel","0000",,"KRF",66,16,82
"0517","Sel","0000",,"H",428,98,526
"0519","Sør-Fron","0000",,"A",595,175,770
"0519","Sør-Fron","0000",,"SP",385,99,484
"0519","Sør-Fron","0000",,"H",60,14,74
"0519","Sør-Fron","0000",,"SFBY",264,60,324
"0520","Ringebu","0000",,"A",441,93,534
"0520","Ringebu","0000",,"SV",21,6,27
"0520","Ringebu","0000",,"SP",507,92,599
"0520","Ringebu","0000",,"V",308,70,378
"0520","Ringebu","0000",,"H",85,17,102
"0520","Ringebu","0000",,"FRP",61,26,87
"0520","Ringebu","0000",,"TVLRING",592,103,695
"0521","Øyer","0000",,"A",576,108,684
"0521","Øyer","0000",,"SV",77,25,102
"0521","Øyer","0000",,"SP",434,58,492
"0521","Øyer","0000",,"KRF",109,16,125
"0521","Øyer","0000",,"V",78,18,96
"0521","Øyer","0000",,"H",676,122,798
"0522","Gausdal","0000",,"A",843,260,1103
"0522","Gausdal","0000",,"SV",60,20,80
"0522","Gausdal","0000",,"SP",452,92,544
"0522","Gausdal","0000",,"V",316,82,398
"0522","Gausdal","0000",,"BYG",304,119,423
"0522","Gausdal","0000",,"FRP_H",197,54,251
"0528","Østre Toten","0000",,"A",2110,554,2664
"0528","Østre Toten","0000",,"SV",121,36,157
"0528","Østre Toten","0000",,"SP",1438,302,1740
"0528","Østre Toten","0000",,"KRF",227,84,311
"0528","Østre Toten","0000",,"V",418,78,496
"0528","Østre Toten","0000",,"H",791,165,956
"0528","Østre Toten","0000",,"FRP",308,119,427
"0528","Østre Toten","0000",,"PP",166,44,210
"0529","Vestre Toten","0000",,"A",2486,426,2912
"0529","Vestre Toten","0000",,"SV",183,24,207
"0529","Vestre Toten","0000",,"RØDT",57,7,64
"0529","Vestre Toten","0000",,"SP",700,52,752
"0529","Vestre Toten","0000",,"KRF",194,42,236
"0529","Vestre Toten","0000",,"V",247,36,283
"0529","Vestre Toten","0000",,"H",997,154,1151
"0529","Vestre Toten","0000",,"FRP",470,106,576
"0532","Jevnaker","0000",,"A",1255,403,1658
"0532","Jevnaker","0000",,"SV",212,48,260
"0532","Jevnaker","0000",,"SP",140,48,188
"0532","Jevnaker","0000",,"H",603,153,756
"0532","Jevnaker","0000",,"FRP",279,68,347
"0533","Lunner","0000",,"A",1418,307,1725
"0533","Lunner","0000",,"SV",126,25,151
"0533","Lunner","0000",,"SP",257,53,310
"0533","Lunner","0000",,"V",238,17,255
"0533","Lunner","0000",,"H",1289,204,1493
"0533","Lunner","0000",,"FRP",325,37,362
"0533","Lunner","0000",,"MDG",91,16,107
"0534","Gran","0000",,"A",2006,465,2471
"0534","Gran","0000",,"SV",141,38,179
"0534","Gran","0000",,"SP",700,92,792
"0534","Gran","0000",,"V",165,34,199
"0534","Gran","0000",,"H",1089,191,1280
"0534","Gran","0000",,"FRP",456,108,564
"0534","Gran","0000",,"GRANB",926,146,1072
"0536","Søndre Land","0000",,"A",963,276,1239
"0536","Søndre Land","0000",,"SV",123,37,160
"0536","Søndre Land","0000",,"H",269,55,324
"0536","Søndre Land","0000",,"FRP",94,42,136
"0536","Søndre Land","0000",,"FKRFSPV",425,95,520
"0536","Søndre Land","0000",,"SLB",188,39,227
"0538","Nordre Land","0000",,"A",1300,331,1631
"0538","Nordre Land","0000",,"SV",131,19,150
"0538","Nordre Land","0000",,"SP",425,54,479
"0538","Nordre Land","0000",,"KRF",77,16,93
"0538","Nordre Land","0000",,"H",236,64,300
"0538","Nordre Land","0000",,"FRP",130,40,170
"0538","Nordre Land","0000",,"BNL",212,52,264
"0540","Sør-Aurdal","0000",,"A",404,88,492
"0540","Sør-Aurdal","0000",,"SP",489,72,561
"0540","Sør-Aurdal","0000",,"KRF",59,14,73
"0540","Sør-Aurdal","0000",,"H",123,27,150
"0540","Sør-Aurdal","0000",,"FRP",131,33,164
"0540","Sør-Aurdal","0000",,"TPK",169,16,185
"0541","Etnedal","0000",,"A",170,71,241
"0541","Etnedal","0000",,"SV",11,8,19
"0541","Etnedal","0000",,"SP",186,60,246
"0541","Etnedal","0000",,"V",47,11,58
"0541","Etnedal","0000",,"H",85,25,110
"0542","Nord-Aurdal","0000",,"A",1007,237,1244
"0542","Nord-Aurdal","0000",,"SV",76,25,101
"0542","Nord-Aurdal","0000",,"SP",405,47,452
"0542","Nord-Aurdal","0000",,"V",300,57,357
"0542","Nord-Aurdal","0000",,"H",369,98,467
"0542","Nord-Aurdal","0000",,"FRP",420,94,514
"0543","Vestre Slidre","0000",,"A",236,35,271
"0543","Vestre Slidre","0000",,"SP",270,55,325
"0543","Vestre Slidre","0000",,"BLVS",476,56,532
"0544","Øystre Slidre","0000",,"A",556,105,661
"0544","Øystre Slidre","0000",,"SP",317,39,356
"0544","Øystre Slidre","0000",,"H",328,56,384
"0544","Øystre Slidre","0000",,"FRP",96,21,117
"0545","Vang","0000",,"A",377,71,448
"0545","Vang","0000",,"SP",219,42,261
"0545","Vang","0000",,"H",68,29,97
"0545","Vang","0000",,"BLV",59,6,65
"0602","Drammen","0000",,"A",6774,2122,8896
"0602","Drammen","0000",,"SV",699,172,871
"0602","Drammen","0000",,"RØDT",176,52,228
"0602","Drammen","0000",,"SP",239,43,282
"0602","Drammen","0000",,"KRF",712,213,925
"0602","Drammen","0000",,"V",942,206,1148
"0602","Drammen","0000",,"H",11807,3238,15045
"0602","Drammen","0000",,"FRP",2060,670,2730
"0602","Drammen","0000",,"DEMN",46,15,61
"0602","Drammen","0000",,"MDG",124,47,171
"0604","Kongsberg","0000",,"A",3428,976,4404
"0604","Kongsberg","0000",,"SV",330,114,444
"0604","Kongsberg","0000",,"RØDT",175,57,232
"0604","Kongsberg","0000",,"SP",876,218,1094
"0604","Kongsberg","0000",,"KRF",438,111,549
"0604","Kongsberg","0000",,"V",1610,559,2169
"0604","Kongsberg","0000",,"H",1792,477,2269
"0604","Kongsberg","0000",,"FRP",887,246,1133
"0605","Ringerike","0000",,"A",3808,1250,5058
"0605","Ringerike","0000",,"SP",690,136,826
"0605","Ringerike","0000",,"KRF",297,79,376
"0605","Ringerike","0000",,"V",644,180,824
"0605","Ringerike","0000",,"H",2958,711,3669
"0605","Ringerike","0000",,"FRP",1401,354,1755
"0605","Ringerike","0000",,"SOLID",787,220,1007
"0612","Hole","0000",,"A",450,136,586
"0612","Hole","0000",,"SV",104,32,136
"0612","Hole","0000",,"SP",208,42,250
"0612","Hole","0000",,"KRF",107,32,139
"0612","Hole","0000",,"V",108,24,132
"0612","Hole","0000",,"H",1367,324,1691
"0612","Hole","0000",,"FRP",182,45,227
"0615","Flå","0000",,"A",71,23,94
"0615","Flå","0000",,"FRP",55,9,64
"0615","Flå","0000",,"BLFLÅ",292,89,381
"0615","Flå","0000",,"FLÅSAM",64,10,74
"0616","Nes","0000",,"A",306,83,389
"0616","Nes","0000",,"SP",283,71,354
"0616","Nes","0000",,"KRF",65,29,94
"0616","Nes","0000",,"H",416,64,480
"0616","Nes","0000",,"FRP",44,14,58
"0616","Nes","0000",,"NEBL",262,42,304
"0617","Gol","0000",,"A",494,201,695
"0617","Gol","0000",,"SV",71,27,98
"0617","Gol","0000",,"SP",211,78,289
"0617","Gol","0000",,"KRF",74,30,104
"0617","Gol","0000",,"V",191,80,271
"0617","Gol","0000",,"H",368,102,470
"0617","Gol","0000",,"FRP",161,66,227
"0618","Hemsedal","0000",,"A",131,37,168
"0618","Hemsedal","0000",,"SV",52,21,73
"0618","Hemsedal","0000",,"SP",293,59,352
"0618","Hemsedal","0000",,"KRF",130,30,160
"0618","Hemsedal","0000",,"H",221,78,299
"0618","Hemsedal","0000",,"FRP",110,36,146
"0619","Ål","0000",,"A",410,121,531
"0619","Ål","0000",,"SV",56,29,85
"0619","Ål","0000",,"SP",494,84,578
"0619","Ål","0000",,"KRF",196,44,240
"0619","Ål","0000",,"V",308,99,407
"0619","Ål","0000",,"H",338,81,419
"0619","Ål","0000",,"FRP",108,43,151
"0620","Hol","0000",,"A",634,218,852
"0620","Hol","0000",,"SP",187,34,221
"0620","Hol","0000",,"KRF",97,12,109
"0620","Hol","0000",,"V",91,19,110
"0620","Hol","0000",,"H",712,193,905
"0620","Hol","0000",,"FRP",120,39,159
"0621","Sigdal","0000",,"A",259,39,298
"0621","Sigdal","0000",,"SP",674,66,740
"0621","Sigdal","0000",,"V",271,30,301
"0621","Sigdal","0000",,"H",294,43,337
"0621","Sigdal","0000",,"FRP",88,17,105
"0622","Krødsherad","0000",,"A",391,71,462
"0622","Krødsherad","0000",,"H",143,36,179
"0622","Krødsherad","0000",,"FRP",21,5,26
"0622","Krødsherad","0000",,"TPKR",400,75,475
"0623","Modum","0000",,"A",1863,514,2377
"0623","Modum","0000",,"SV",153,39,192
"0623","Modum","0000",,"SP",931,146,1077
"0623","Modum","0000",,"KRF",178,48,226
"0623","Modum","0000",,"V",149,35,184
"0623","Modum","0000",,"H",743,191,934
"0623","Modum","0000",,"FRP",640,125,765
"0623","Modum","0000",,"BLM",329,58,387
"0624","Øvre Eiker","0000",,"A",1928,329,2257
"0624","Øvre Eiker","0000",,"SV",254,36,290
"0624","Øvre Eiker","0000",,"RØDT",38,8,46
"0624","Øvre Eiker","0000",,"SP",656,91,747
"0624","Øvre Eiker","0000",,"KRF",228,37,265
"0624","Øvre Eiker","0000",,"V",135,17,152
"0624","Øvre Eiker","0000",,"H",2917,370,3287
"0624","Øvre Eiker","0000",,"FRP",657,113,770
"0625","Nedre Eiker","0000",,"A",3532,742,4274
"0625","Nedre Eiker","0000",,"SV",326,80,406
"0625","Nedre Eiker","0000",,"RØDT",47,10,57
"0625","Nedre Eiker","0000",,"KRF",344,82,426
"0625","Nedre Eiker","0000",,"V",238,48,286
"0625","Nedre Eiker","0000",,"H",2943,520,3463
"0625","Nedre Eiker","0000",,"FRP",1063,229,1292
"0626","Lier","0000",,"A",2951,763,3714
"0626","Lier","0000",,"SV",301,85,386
"0626","Lier","0000",,"RØDT",55,13,68
"0626","Lier","0000",,"SP",478,84,562
"0626","Lier","0000",,"KRF",282,60,342
"0626","Lier","0000",,"V",400,70,470
"0626","Lier","0000",,"H",3850,771,4621
"0626","Lier","0000",,"FRP",946,222,1168
"0626","Lier","0000",,"MDG",78,18,96
"0626","Lier","0000",,"UF",119,23,142
"0627","Røyken","0000",,"A",2287,451,2738
"0627","Røyken","0000",,"SV",230,43,273
"0627","Røyken","0000",,"RØDT",95,12,107
"0627","Røyken","0000",,"SP",163,21,184
"0627","Røyken","0000",,"KRF",186,26,212
"0627","Røyken","0000",,"V",499,74,573
"0627","Røyken","0000",,"H",3510,551,4061
"0627","Røyken","0000",,"FRP",884,155,1039
"0627","Røyken","0000",,"MDG",77,15,92
"0628","Hurum","0000",,"A",1158,218,1376
"0628","Hurum","0000",,"SV",160,42,202
"0628","Hurum","0000",,"SP",150,26,176
"0628","Hurum","0000",,"KRF",99,33,132
"0628","Hurum","0000",,"V",298,40,338
"0628","Hurum","0000",,"H",1602,266,1868
"0628","Hurum","0000",,"FRP",353,77,430
"0628","Hurum","0000",,"PP",46,15,61
"0631","Flesberg","0000",,"A",242,39,281
"0631","Flesberg","0000",,"SP",228,35,263
"0631","Flesberg","0000",,"V",32,14,46
"0631","Flesberg","0000",,"H",429,41,470
"0631","Flesberg","0000",,"FRP",274,16,290
"0632","Rollag","0000",,"A",255,35,290
"0632","Rollag","0000",,"SP",190,26,216
"0632","Rollag","0000",,"KRF",44,5,49
"0632","Rollag","0000",,"H",171,21,192
"0633","Nore Og Uvdal","0000",,"A",368,68,436
"0633","Nore Og Uvdal","0000",,"SV",40,11,51
"0633","Nore Og Uvdal","0000",,"SP",370,52,422
"0633","Nore Og Uvdal","0000",,"H",213,40,253
"0633","Nore Og Uvdal","0000",,"FRP",147,28,175
"0701","Horten","0000",,"A",3289,1357,4646
"0701","Horten","0000",,"SV",317,88,405
"0701","Horten","0000",,"RØDT",373,142,515
"0701","Horten","0000",,"SP",291,50,341
"0701","Horten","0000",,"KRF",266,97,363
"0701","Horten","0000",,"V",533,120,653
"0701","Horten","0000",,"H",3838,1193,5031
"0701","Horten","0000",,"FRP",733,272,1005
"0701","Horten","0000",,"KSP",48,7,55
"0701","Horten","0000",,"VPP",87,36,123
"0702","Holmestrand","0000",,"A",1214,252,1466
"0702","Holmestrand","0000",,"SV",207,46,253
"0702","Holmestrand","0000",,"SP",280,27,307
"0702","Holmestrand","0000",,"KRF",186,43,229
"0702","Holmestrand","0000",,"V",131,26,157
"0702","Holmestrand","0000",,"H",1934,376,2310
"0702","Holmestrand","0000",,"FRP",245,51,296
"0704","Tønsberg","0000",,"A",5172,1191,6363
"0704","Tønsberg","0000",,"SV",804,231,1035
"0704","Tønsberg","0000",,"RØDT",94,31,125
"0704","Tønsberg","0000",,"SP",405,41,446
"0704","Tønsberg","0000",,"KRF",763,216,979
"0704","Tønsberg","0000",,"V",771,165,936
"0704","Tønsberg","0000",,"H",6002,1231,7233
"0704","Tønsberg","0000",,"FRP",1608,347,1955
"0704","Tønsberg","0000",,"KSP",87,23,110
"0704","Tønsberg","0000",,"KYST",92,8,100
"0704","Tønsberg","0000",,"MDG",103,34,137
"0704","Tønsberg","0000",,"BMB",112,18,130
"0706","Sandefjord","0000",,"A",3451,1199,4650
"0706","Sandefjord","0000",,"SV",664,197,861
"0706","Sandefjord","0000",,"RØDT",83,29,112
"0706","Sandefjord","0000",,"SP",200,31,231
"0706","Sandefjord","0000",,"KRF",634,193,827
"0706","Sandefjord","0000",,"V",750,183,933
"0706","Sandefjord","0000",,"H",7780,2098,9878
"0706","Sandefjord","0000",,"FRP",1892,582,2474
"0706","Sandefjord","0000",,"KYST",31,4,35
"0706","Sandefjord","0000",,"MDG",151,55,206
"0706","Sandefjord","0000",,"PP",286,130,416
"0709","Larvik","0000",,"A",6632,1264,7896
"0709","Larvik","0000",,"SV",417,135,552
"0709","Larvik","0000",,"RØDT",176,56,232
"0709","Larvik","0000",,"SP",604,66,670
"0709","Larvik","0000",,"KRF",1022,246,1268
"0709","Larvik","0000",,"V",1328,227,1555
"0709","Larvik","0000",,"H",3045,575,3620
"0709","Larvik","0000",,"FRP",3766,574,4340
"0709","Larvik","0000",,"MDG",339,42,381
"0711","Svelvik","0000",,"A",1177,193,1370
"0711","Svelvik","0000",,"SP",151,14,165
"0711","Svelvik","0000",,"KRF",70,16,86
"0711","Svelvik","0000",,"V",168,20,188
"0711","Svelvik","0000",,"H",682,105,787
"0711","Svelvik","0000",,"FRP",373,40,413
"0713","Sande","0000",,"A",1723,305,2028
"0713","Sande","0000",,"SV",83,15,98
"0713","Sande","0000",,"SP",287,36,323
"0713","Sande","0000",,"KRF",141,35,176
"0713","Sande","0000",,"V",236,33,269
"0713","Sande","0000",,"H",588,105,693
"0713","Sande","0000",,"FRP",471,90,561
"0714","Hof","0000",,"A",267,71,338
"0714","Hof","0000",,"SV",44,8,52
"0714","Hof","0000",,"SP",311,57,368
"0714","Hof","0000",,"V",41,12,53
"0714","Hof","0000",,"H",586,144,730
"0716","Re","0000",,"A",480,268,748
"0716","Re","0000",,"SV",94,41,135
"0716","Re","0000",,"SP",1218,442,1660
"0716","Re","0000",,"V",118,38,156
"0716","Re","0000",,"FRP",442,184,626
"0716","Re","0000",,"KYST",21,7,28
"0716","Re","0000",,"RE_H_KRF",702,294,996
"0719","Andebu","0000",,"A",619,91,710
"0719","Andebu","0000",,"SV",52,16,68
"0719","Andebu","0000",,"SP",409,30,439
"0719","Andebu","0000",,"KRF",151,18,169
"0719","Andebu","0000",,"V",163,29,192
"0719","Andebu","0000",,"H",530,70,600
"0719","Andebu","0000",,"FRP",317,39,356
"0720","Stokke","0000",,"A",1528,454,1982
"0720","Stokke","0000",,"SV",150,41,191
"0720","Stokke","0000",,"SP",205,36,241
"0720","Stokke","0000",,"KRF",303,69,372
"0720","Stokke","0000",,"V",188,49,237
"0720","Stokke","0000",,"H",1553,408,1961
"0720","Stokke","0000",,"FRP",374,112,486
"0722","Nøtterøy","0000",,"A",2441,610,3051
"0722","Nøtterøy","0000",,"SP",80,18,98
"0722","Nøtterøy","0000",,"KRF",407,101,508
"0722","Nøtterøy","0000",,"V",493,106,599
"0722","Nøtterøy","0000",,"H",3455,864,4319
"0722","Nøtterøy","0000",,"FRP",949,294,1243
"0722","Nøtterøy","0000",,"BOM",176,33,209
"0722","Nøtterøy","0000",,"RV_SV",676,166,842
"0723","Tjøme","0000",,"A",588,243,831
"0723","Tjøme","0000",,"RØDT",41,21,62
"0723","Tjøme","0000",,"SP",23,8,31
"0723","Tjøme","0000",,"KRF",52,28,80
"0723","Tjøme","0000",,"V",171,47,218
"0723","Tjøme","0000",,"H",503,245,748
"0723","Tjøme","0000",,"FRP",353,160,513
"0723","Tjøme","0000",,"TJL",94,37,131
"0728","Lardal","0000",,"A",378,62,440
"0728","Lardal","0000",,"SV",21,10,31
"0728","Lardal","0000",,"SP",254,31,285
"0728","Lardal","0000",,"KRF",68,16,84
"0728","Lardal","0000",,"V",47,10,57
"0728","Lardal","0000",,"H",278,24,302
"0728","Lardal","0000",,"FRP",99,21,120
"0805","Porsgrunn","0000",,"A",4776,971,5747
"0805","Porsgrunn","0000",,"SV",517,118,635
"0805","Porsgrunn","0000",,"RØDT",314,75,389
"0805","Porsgrunn","0000",,"SP",146,22,168
"0805","Porsgrunn","0000",,"KRF",687,152,839
"0805","Porsgrunn","0000",,"V",780,185,965
"0805","Porsgrunn","0000",,"H",2785,532,3317
"0805","Porsgrunn","0000",,"FRP",1549,265,1814
"0805","Porsgrunn","0000",,"MDG",271,46,317
"0805","Porsgrunn","0000",,"BYN",2693,404,3097
"0806","Skien","0000",,"A",7375,1563,8938
"0806","Skien","0000",,"SV",881,223,1104
"0806","Skien","0000",,"RØDT",226,68,294
"0806","Skien","0000",,"SP",516,75,591
"0806","Skien","0000",,"KRF",1530,304,1834
"0806","Skien","0000",,"V",1041,184,1225
"0806","Skien","0000",,"H",5485,892,6377
"0806","Skien","0000",,"FRP",2581,496,3077
"0806","Skien","0000",,"DEMN",65,27,92
"0806","Skien","0000",,"MDG",162,39,201
"0806","Skien","0000",,"PP",154,37,191
"0807","Notodden","0000",,"A",1562,312,1874
"0807","Notodden","0000",,"SP",309,31,340
"0807","Notodden","0000",,"KRF",527,98,625
"0807","Notodden","0000",,"V",442,91,533
"0807","Notodden","0000",,"H",910,149,1059
"0807","Notodden","0000",,"FRP",504,84,588
"0807","Notodden","0000",,"MDG",47,20,67
"0807","Notodden","0000",,"SOLA",558,133,691
"0811","Siljan","0000",,"A",558,109,667
"0811","Siljan","0000",,"SV",53,14,67
"0811","Siljan","0000",,"SP",91,12,103
"0811","Siljan","0000",,"H_KRF_SI",249,36,285
"0814","Bamble","0000",,"A",1936,477,2413
"0814","Bamble","0000",,"RØDT",164,57,221
"0814","Bamble","0000",,"SP",236,38,274
"0814","Bamble","0000",,"KRF",379,80,459
"0814","Bamble","0000",,"V",184,45,229
"0814","Bamble","0000",,"H",752,193,945
"0814","Bamble","0000",,"FRP",1813,358,2171
"0815","Kragerø","0000",,"A",1444,404,1848
"0815","Kragerø","0000",,"SV",163,57,220
"0815","Kragerø","0000",,"RØDT",303,94,397
"0815","Kragerø","0000",,"SP",119,21,140
"0815","Kragerø","0000",,"KRF",291,65,356
"0815","Kragerø","0000",,"V",213,81,294
"0815","Kragerø","0000",,"H",1303,333,1636
"0815","Kragerø","0000",,"FRP",409,143,552
"0817","Drangedal","0000",,"A",838,160,998
"0817","Drangedal","0000",,"SV",69,18,87
"0817","Drangedal","0000",,"SP",222,27,249
"0817","Drangedal","0000",,"KRF",132,29,161
"0817","Drangedal","0000",,"V",160,34,194
"0817","Drangedal","0000",,"H",196,52,248
"0817","Drangedal","0000",,"FRP",132,25,157
"0819","Nome","0000",,"A",1181,169,1350
"0819","Nome","0000",,"SV",85,16,101
"0819","Nome","0000",,"SP",584,86,670
"0819","Nome","0000",,"KRF",160,17,177
"0819","Nome","0000",,"V",102,14,116
"0819","Nome","0000",,"H",414,71,485
"0819","Nome","0000",,"FRP",341,51,392
"0821","Bø","0000",,"A",375,155,530
"0821","Bø","0000",,"SV",113,55,168
"0821","Bø","0000",,"SP",184,38,222
"0821","Bø","0000",,"KRF",206,63,269
"0821","Bø","0000",,"V",809,214,1023
"0821","Bø","0000",,"H",238,91,329
"0821","Bø","0000",,"FRP",164,60,224
"0822","Sauherad","0000",,"A",532,66,598
"0822","Sauherad","0000",,"SV",84,11,95
"0822","Sauherad","0000",,"SP",295,25,320
"0822","Sauherad","0000",,"KRF",396,49,445
"0822","Sauherad","0000",,"V",85,19,104
"0822","Sauherad","0000",,"H",273,14,287
"0822","Sauherad","0000",,"FRP",183,23,206
"0826","Tinn","0000",,"A",850,301,1151
"0826","Tinn","0000",,"SV",151,48,199
"0826","Tinn","0000",,"SP",286,34,320
"0826","Tinn","0000",,"KRF",53,27,80
"0826","Tinn","0000",,"V",141,37,178
"0826","Tinn","0000",,"H",660,164,824
"0826","Tinn","0000",,"FRP",186,66,252
"0827","Hjartdal","0000",,"A",523,78,601
"0827","Hjartdal","0000",,"SP",154,23,177
"0827","Hjartdal","0000",,"KRF",114,16,130
"0828","Seljord","0000",,"A",247,57,304
"0828","Seljord","0000",,"SV",57,13,70
"0828","Seljord","0000",,"SP",121,24,145
"0828","Seljord","0000",,"KRF",149,27,176
"0828","Seljord","0000",,"V",71,12,83
"0828","Seljord","0000",,"H",499,63,562
"0828","Seljord","0000",,"FRP",101,27,128
"0829","Kviteseid","0000",,"A",354,59,413
"0829","Kviteseid","0000",,"SP",349,47,396
"0829","Kviteseid","0000",,"KRF",108,39,147
"0829","Kviteseid","0000",,"V",84,6,90
"0829","Kviteseid","0000",,"H",135,24,159
"0830","Nissedal","0000",,"A",205,58,263
"0830","Nissedal","0000",,"SP",211,32,243
"0830","Nissedal","0000",,"KRF",139,36,175
"0830","Nissedal","0000",,"H",73,13,86
"0830","Nissedal","0000",,"FRP",85,10,95
"0831","Fyresdal","0000",,"A",340,78,418
"0831","Fyresdal","0000",,"SP",140,30,170
"0831","Fyresdal","0000",,"BLFY",93,41,134
"0833","Tokke","0000",,"A",506,96,602
"0833","Tokke","0000",,"SP",363,42,405
"0833","Tokke","0000",,"KRF",55,13,68
"0833","Tokke","0000",,"H",155,30,185
"0833","Tokke","0000",,"FRP",43,13,56
"0834","Vinje","0000",,"A",384,81,465
"0834","Vinje","0000",,"SV",338,107,445
"0834","Vinje","0000",,"SP",330,58,388
"0834","Vinje","0000",,"KRF",74,25,99
"0834","Vinje","0000",,"V",49,15,64
"0834","Vinje","0000",,"H",201,30,231
"0834","Vinje","0000",,"FRP",121,28,149
"0901","Risør","0000",,"A",1069,257,1326
"0901","Risør","0000",,"RØDT",327,112,439
"0901","Risør","0000",,"SP",84,8,92
"0901","Risør","0000",,"KRF",204,39,243
"0901","Risør","0000",,"V",404,73,477
"0901","Risør","0000",,"H",544,137,681
"0901","Risør","0000",,"FRP",214,43,257
"0901","Risør","0000",,"VPP",30,12,42
"0904","Grimstad","0000",,"A",1820,660,2480
"0904","Grimstad","0000",,"SV",184,103,287
"0904","Grimstad","0000",,"SP",358,84,442
"0904","Grimstad","0000",,"KRF",1086,332,1418
"0904","Grimstad","0000",,"V",1540,459,1999
"0904","Grimstad","0000",,"H",1055,321,1376
"0904","Grimstad","0000",,"FRP",1433,405,1838
"0904","Grimstad","0000",,"PP",123,37,160
"0906","Arendal","0000",,"A",3486,1201,4687
"0906","Arendal","0000",,"SV",909,394,1303
"0906","Arendal","0000",,"SP",493,105,598
"0906","Arendal","0000",,"KRF",1167,331,1498
"0906","Arendal","0000",,"V",1046,314,1360
"0906","Arendal","0000",,"H",4665,1527,6192
"0906","Arendal","0000",,"FRP",2313,635,2948
"0906","Arendal","0000",,"KYST",26,11,37
"0906","Arendal","0000",,"PP",854,315,1169
"0906","Arendal","0000",,"VPP",66,21,87
"0911","Gjerstad","0000",,"A",284,109,393
"0911","Gjerstad","0000",,"SP",246,59,305
"0911","Gjerstad","0000",,"KRF",53,20,73
"0911","Gjerstad","0000",,"V",44,18,62
"0911","Gjerstad","0000",,"H",286,85,371
"0911","Gjerstad","0000",,"FRP",95,8,103
"0912","Vegårshei","0000",,"A",278,53,331
"0912","Vegårshei","0000",,"SP",176,24,200
"0912","Vegårshei","0000",,"KRF",201,40,241
"0912","Vegårshei","0000",,"V",25,9,34
"0912","Vegårshei","0000",,"H",212,50,262
"0912","Vegårshei","0000",,"FRP",65,11,76
"0914","Tvedestrand","0000",,"A",595,153,748
"0914","Tvedestrand","0000",,"SP",281,41,322
"0914","Tvedestrand","0000",,"KRF",227,50,277
"0914","Tvedestrand","0000",,"V",123,37,160
"0914","Tvedestrand","0000",,"H",351,117,468
"0914","Tvedestrand","0000",,"FRP",118,27,145
"0914","Tvedestrand","0000",,"TTL",762,158,920
"0919","Froland","0000",,"A",321,136,457
"0919","Froland","0000",,"SP",560,171,731
"0919","Froland","0000",,"KRF",454,121,575
"0919","Froland","0000",,"V",58,20,78
"0919","Froland","0000",,"H",169,36,205
"0919","Froland","0000",,"FRP",245,94,339
"0926","Lillesand","0000",,"A",608,214,822
"0926","Lillesand","0000",,"SV",150,46,196
"0926","Lillesand","0000",,"SP",112,23,135
"0926","Lillesand","0000",,"KRF",350,92,442
"0926","Lillesand","0000",,"V",300,89,389
"0926","Lillesand","0000",,"H",1786,558,2344
"0926","Lillesand","0000",,"FRP",284,88,372
"0926","Lillesand","0000",,"MDG",41,23,64
"0926","Lillesand","0000",,"PP",112,63,175
"0928","Birkenes","0000",,"A",287,101,388
"0928","Birkenes","0000",,"SV",44,26,70
"0928","Birkenes","0000",,"SP",188,41,229
"0928","Birkenes","0000",,"KRF",279,139,418
"0928","Birkenes","0000",,"V",41,14,55
"0928","Birkenes","0000",,"H",672,181,853
"0928","Birkenes","0000",,"FRP",144,50,194
"0929","Åmli","0000",,"A",284,45,329
"0929","Åmli","0000",,"SP",218,28,246
"0929","Åmli","0000",,"KRF",124,25,149
"0929","Åmli","0000",,"H",158,28,186
"0929","Åmli","0000",,"FRP",69,18,87
"0935","Iveland","0000",,"A",96,14,110
"0935","Iveland","0000",,"SP",206,24,230
"0935","Iveland","0000",,"KRF",81,32,113
"0935","Iveland","0000",,"V",76,6,82
"0935","Iveland","0000",,"H",70,16,86
"0935","Iveland","0000",,"FRP",56,8,64
"0937","Evje Og Hornnes","0000",,"A",353,92,445
"0937","Evje Og Hornnes","0000",,"SP",123,25,148
"0937","Evje Og Hornnes","0000",,"KRF",468,86,554
"0937","Evje Og Hornnes","0000",,"H",242,40,282
"0937","Evje Og Hornnes","0000",,"FRP",72,29,101
"0937","Evje Og Hornnes","0000",,"TBY",97,17,114
"0938","Bygland","0000",,"A",105,33,138
"0938","Bygland","0000",,"SP",210,44,254
"0938","Bygland","0000",,"BHBV",78,39,117
"0938","Bygland","0000",,"BYB",156,26,182
"0940","Valle","0000",,"A",133,54,187
"0940","Valle","0000",,"SP",227,50,277
"0940","Valle","0000",,"KRF",27,8,35
"0940","Valle","0000",,"V",23,13,36
"0940","Valle","0000",,"H",124,31,155
"0941","Bykle","0000",,"A",162,38,200
"0941","Bykle","0000",,"SP",54,16,70
"0941","Bykle","0000",,"V",32,16,48
"0941","Bykle","0000",,"H",122,32,154
"0941","Bykle","0000",,"FRP",23,12,35
"1001","Kristiansand","0000",,"A",7996,2188,10184
"1001","Kristiansand","0000",,"SV",788,294,1082
"1001","Kristiansand","0000",,"RØDT",455,163,618
"1001","Kristiansand","0000",,"SP",251,30,281
"1001","Kristiansand","0000",,"KRF",5257,1121,6378
"1001","Kristiansand","0000",,"V",1502,381,1883
"1001","Kristiansand","0000",,"H",8249,1971,10220
"1001","Kristiansand","0000",,"FRP",3469,900,4369
"1001","Kristiansand","0000",,"DEMN",1140,337,1477
"1001","Kristiansand","0000",,"MDG",639,178,817
"1001","Kristiansand","0000",,"PP",930,363,1293
"1002","Mandal","0000",,"A",1280,569,1849
"1002","Mandal","0000",,"SV",143,75,218
"1002","Mandal","0000",,"SP",144,27,171
"1002","Mandal","0000",,"KRF",822,314,1136
"1002","Mandal","0000",,"V",296,118,414
"1002","Mandal","0000",,"H",865,418,1283
"1002","Mandal","0000",,"FRP",1451,623,2074
"1002","Mandal","0000",,"DEMN",17,10,27
"1002","Mandal","0000",,"MDG",103,51,154
"1003","Farsund","0000",,"A",492,175,667
"1003","Farsund","0000",,"SV",136,58,194
"1003","Farsund","0000",,"SP",114,49,163
"1003","Farsund","0000",,"KRF",437,134,571
"1003","Farsund","0000",,"V",197,47,244
"1003","Farsund","0000",,"H",800,264,1064
"1003","Farsund","0000",,"FRP",1261,409,1670
"1003","Farsund","0000",,"PP",110,26,136
"1004","Flekkefjord","0000",,"A",531,159,690
"1004","Flekkefjord","0000",,"SV",113,53,166
"1004","Flekkefjord","0000",,"SP",295,36,331
"1004","Flekkefjord","0000",,"KRF",591,125,716
"1004","Flekkefjord","0000",,"V",530,131,661
"1004","Flekkefjord","0000",,"H",944,238,1182
"1004","Flekkefjord","0000",,"FRP",517,131,648
"1014","Vennesla","0000",,"A",1448,214,1662
"1014","Vennesla","0000",,"SV",68,15,83
"1014","Vennesla","0000",,"SP",381,36,417
"1014","Vennesla","0000",,"KRF",1584,245,1829
"1014","Vennesla","0000",,"V",130,23,153
"1014","Vennesla","0000",,"H",828,81,909
"1014","Vennesla","0000",,"FRP",752,121,873
"1014","Vennesla","0000",,"DEMN",30,4,34
"1014","Vennesla","0000",,"PP",84,19,103
"1017","Songdalen","0000",,"A",531,67,598
"1017","Songdalen","0000",,"SP",570,77,647
"1017","Songdalen","0000",,"KRF",367,50,417
"1017","Songdalen","0000",,"V",84,10,94
"1017","Songdalen","0000",,"H",396,37,433
"1017","Songdalen","0000",,"FRP",368,54,422
"1017","Songdalen","0000",,"DEMN",40,7,47
"1018","Søgne","0000",,"A",916,237,1153
"1018","Søgne","0000",,"SV",120,49,169
"1018","Søgne","0000",,"SP",120,17,137
"1018","Søgne","0000",,"KRF",539,81,620
"1018","Søgne","0000",,"V",307,61,368
"1018","Søgne","0000",,"H",1351,245,1596
"1018","Søgne","0000",,"FRP",758,148,906
"1018","Søgne","0000",,"DEMN",14,5,19
"1018","Søgne","0000",,"PP",77,8,85
"1018","Søgne","0000",,"SØBYG",47,14,61
"1021","Marnardal","0000",,"A",339,63,402
"1021","Marnardal","0000",,"SP",178,31,209
"1021","Marnardal","0000",,"KRF",139,9,148
"1021","Marnardal","0000",,"V",49,11,60
"1021","Marnardal","0000",,"H",153,16,169
"1021","Marnardal","0000",,"FRP",62,18,80
"1026","Åseral","0000",,"A",84,12,96
"1026","Åseral","0000",,"SP",189,31,220
"1026","Åseral","0000",,"H",49,10,59
"1026","Åseral","0000",,"TPÅS",67,14,81
"1027","Audnedal","0000",,"A",128,21,149
"1027","Audnedal","0000",,"SP",63,9,72
"1027","Audnedal","0000",,"KRF",232,26,258
"1027","Audnedal","0000",,"H",66,13,79
"1027","Audnedal","0000",,"BØA",326,23,349
"1029","Lindesnes","0000",,"A",158,61,219
"1029","Lindesnes","0000",,"SP",133,14,147
"1029","Lindesnes","0000",,"KRF",473,107,580
"1029","Lindesnes","0000",,"V",367,46,413
"1029","Lindesnes","0000",,"H",534,87,621
"1029","Lindesnes","0000",,"FRP",158,41,199
"1029","Lindesnes","0000",,"DEMN",9,5,14
"1029","Lindesnes","0000",,"PP",142,51,193
"1032","Lyngdal","0000",,"A",302,76,378
"1032","Lyngdal","0000",,"SV",73,34,107
"1032","Lyngdal","0000",,"SP",346,66,412
"1032","Lyngdal","0000",,"KRF",484,127,611
"1032","Lyngdal","0000",,"V",150,37,187
"1032","Lyngdal","0000",,"H",1375,335,1710
"1032","Lyngdal","0000",,"FRP",304,90,394
"1032","Lyngdal","0000",,"DEMN",7,3,10
"1034","Hægebostad","0000",,"A",53,10,63
"1034","Hægebostad","0000",,"SP",87,10,97
"1034","Hægebostad","0000",,"KRF",84,11,95
"1034","Hægebostad","0000",,"H",242,20,262
"1034","Hægebostad","0000",,"FRP",113,34,147
"1034","Hægebostad","0000",,"SAMH",131,11,142
"1034","Hægebostad","0000",,"TPLH",135,10,145
"1037","Kvinesdal","0000",,"A",925,278,1203
"1037","Kvinesdal","0000",,"SP",171,37,208
"1037","Kvinesdal","0000",,"KRF",357,138,495
"1037","Kvinesdal","0000",,"V",57,14,71
"1037","Kvinesdal","0000",,"H",422,129,551
"1037","Kvinesdal","0000",,"FRP",359,123,482
"1046","Sirdal","0000",,"A",203,85,288
"1046","Sirdal","0000",,"SP",122,20,142
"1046","Sirdal","0000",,"KRF",108,45,153
"1046","Sirdal","0000",,"V",46,15,61
"1046","Sirdal","0000",,"H",79,30,109
"1046","Sirdal","0000",,"FRP",61,28,89
"1046","Sirdal","0000",,"BUTV",109,27,136
"1101","Eigersund","0000",,"A",1266,364,1630
"1101","Eigersund","0000",,"SV",119,45,164
"1101","Eigersund","0000",,"SP",362,59,421
"1101","Eigersund","0000",,"KRF",1012,244,1256
"1101","Eigersund","0000",,"V",314,101,415
"1101","Eigersund","0000",,"H",1354,339,1693
"1101","Eigersund","0000",,"FRP",700,202,902
"1102","Sandnes","0000",,"A",4238,2330,6568
"1102","Sandnes","0000",,"SV",615,337,952
"1102","Sandnes","0000",,"RØDT",77,50,127
"1102","Sandnes","0000",,"SP",1310,338,1648
"1102","Sandnes","0000",,"KRF",2037,760,2797
"1102","Sandnes","0000",,"V",832,493,1325
"1102","Sandnes","0000",,"H",5754,3290,9044
"1102","Sandnes","0000",,"FRP",4495,2326,6821
"1102","Sandnes","0000",,"DEMN",18,10,28
"1102","Sandnes","0000",,"KSP",74,32,106
"1102","Sandnes","0000",,"MDG",95,75,170
"1102","Sandnes","0000",,"PP",442,161,603
"1103","Stavanger","FORH","Forhånd ikke kretsfordelt","A",0,2434,2434
"1103","Stavanger","FORH","Forhånd ikke kretsfordelt","SV",0,459,459
"1103","Stavanger","FORH","Forhånd ikke kretsfordelt","RØDT",0,126,126
"1103","Stavanger","FORH","Forhånd ikke kretsfordelt","SP",0,138,138
"1103","Stavanger","FORH","Forhånd ikke kretsfordelt","KRF",0,521,521
"1103","Stavanger","FORH","Forhånd ikke kretsfordelt","V",0,680,680
"1103","Stavanger","FORH","Forhånd ikke kretsfordelt","H",0,2740,2740
"1103","Stavanger","FORH","Forhånd ikke kretsfordelt","FRP",0,1000,1000
"1103","Stavanger","FORH","Forhånd ikke kretsfordelt","DEMN",0,20,20
"1103","Stavanger","FORH","Forhånd ikke kretsfordelt","MDG",0,86,86
"1103","Stavanger","FORH","Forhånd ikke kretsfordelt","PP",0,151,151
"1103","Stavanger","FREM","Fremmede ikke kretsfordelt","A",162,0,162
"1103","Stavanger","FREM","Fremmede ikke kretsfordelt","SV",27,0,27
"1103","Stavanger","FREM","Fremmede ikke kretsfordelt","RØDT",15,0,15
"1103","Stavanger","FREM","Fremmede ikke kretsfordelt","SP",9,0,9
"1103","Stavanger","FREM","Fremmede ikke kretsfordelt","KRF",24,0,24
"1103","Stavanger","FREM","Fremmede ikke kretsfordelt","V",59,0,59
"1103","Stavanger","FREM","Fremmede ikke kretsfordelt","H",170,0,170
"1103","Stavanger","FREM","Fremmede ikke kretsfordelt","FRP",65,0,65
"1103","Stavanger","FREM","Fremmede ikke kretsfordelt","MDG",15,0,15
"1103","Stavanger","FREM","Fremmede ikke kretsfordelt","PP",1,0,1
"1103","Stavanger","VALG","Valgting ikke kretsfordelt","A",8,0,8
"1103","Stavanger","VALG","Valgting ikke kretsfordelt","RØDT",1,0,1
"1103","Stavanger","VALG","Valgting ikke kretsfordelt","KRF",3,0,3
"1103","Stavanger","VALG","Valgting ikke kretsfordelt","V",3,0,3
"1103","Stavanger","VALG","Valgting ikke kretsfordelt","H",10,0,10
"1103","Stavanger","VALG","Valgting ikke kretsfordelt","FRP",9,0,9
"1103","Stavanger","VALG","Valgting ikke kretsfordelt","MDG",1,0,1
"1103","Stavanger","VALG","Valgting ikke kretsfordelt","PP",1,0,1
"1103","Stavanger","0001","Buøy/Hundvåg","A",1647,0,1647
"1103","Stavanger","0001","Buøy/Hundvåg","SV",109,0,109
"1103","Stavanger","0001","Buøy/Hundvåg","RØDT",40,0,40
"1103","Stavanger","0001","Buøy/Hundvåg","SP",65,0,65
"1103","Stavanger","0001","Buøy/Hundvåg","KRF",138,0,138
"1103","Stavanger","0001","Buøy/Hundvåg","V",179,0,179
"1103","Stavanger","0001","Buøy/Hundvåg","H",1618,0,1618
"1103","Stavanger","0001","Buøy/Hundvåg","FRP",829,0,829
"1103","Stavanger","0001","Buøy/Hundvåg","DEMN",4,0,4
"1103","Stavanger","0001","Buøy/Hundvåg","MDG",37,0,37
"1103","Stavanger","0001","Buøy/Hundvåg","PP",96,0,96
"1103","Stavanger","0004","Varden","A",800,0,800
"1103","Stavanger","0004","Varden","SV",165,0,165
"1103","Stavanger","0004","Varden","RØDT",69,0,69
"1103","Stavanger","0004","Varden","SP",40,0,40
"1103","Stavanger","0004","Varden","KRF",136,0,136
"1103","Stavanger","0004","Varden","V",264,0,264
"1103","Stavanger","0004","Varden","H",660,0,660
"1103","Stavanger","0004","Varden","FRP",257,0,257
"1103","Stavanger","0004","Varden","DEMN",4,0,4
"1103","Stavanger","0004","Varden","MDG",38,0,38
"1103","Stavanger","0004","Varden","PP",41,0,41
"1103","Stavanger","0005","Storhaug","A",679,0,679
"1103","Stavanger","0005","Storhaug","SV",165,0,165
"1103","Stavanger","0005","Storhaug","RØDT",86,0,86
"1103","Stavanger","0005","Storhaug","SP",40,0,40
"1103","Stavanger","0005","Storhaug","KRF",76,0,76
"1103","Stavanger","0005","Storhaug","V",286,0,286
"1103","Stavanger","0005","Storhaug","H",766,0,766
"1103","Stavanger","0005","Storhaug","FRP",246,0,246
"1103","Stavanger","0005","Storhaug","DEMN",4,0,4
"1103","Stavanger","0005","Storhaug","MDG",70,0,70
"1103","Stavanger","0005","Storhaug","PP",37,0,37
"1103","Stavanger","0006","Våland","A",616,0,616
"1103","Stavanger","0006","Våland","SV",141,0,141
"1103","Stavanger","0006","Våland","RØDT",58,0,58
"1103","Stavanger","0006","Våland","SP",37,0,37
"1103","Stavanger","0006","Våland","KRF",87,0,87
"1103","Stavanger","0006","Våland","V",220,0,220
"1103","Stavanger","0006","Våland","H",655,0,655
"1103","Stavanger","0006","Våland","FRP",195,0,195
"1103","Stavanger","0006","Våland","DEMN",2,0,2
"1103","Stavanger","0006","Våland","MDG",45,0,45
"1103","Stavanger","0006","Våland","PP",33,0,33
"1103","Stavanger","0007","Ullandhaug","A",886,0,886
"1103","Stavanger","0007","Ullandhaug","SV",161,0,161
"1103","Stavanger","0007","Ullandhaug","RØDT",39,0,39
"1103","Stavanger","0007","Ullandhaug","SP",60,0,60
"1103","Stavanger","0007","Ullandhaug","KRF",179,0,179
"1103","Stavanger","0007","Ullandhaug","V",203,0,203
"1103","Stavanger","0007","Ullandhaug","H",761,0,761
"1103","Stavanger","0007","Ullandhaug","FRP",332,0,332
"1103","Stavanger","0007","Ullandhaug","DEMN",6,0,6
"1103","Stavanger","0007","Ullandhaug","MDG",37,0,37
"1103","Stavanger","0007","Ullandhaug","PP",50,0,50
"1103","Stavanger","0008","Eiganes","A",620,0,620
"1103","Stavanger","0008","Eiganes","SV",99,0,99
"1103","Stavanger","0008","Eiganes","RØDT",31,0,31
"1103","Stavanger","0008","Eiganes","SP",34,0,34
"1103","Stavanger","0008","Eiganes","KRF",75,0,75
"1103","Stavanger","0008","Eiganes","V",262,0,262
"1103","Stavanger","0008","Eiganes","H",1008,0,1008
"1103","Stavanger","0008","Eiganes","FRP",254,0,254
"1103","Stavanger","0008","Eiganes","DEMN",4,0,4
"1103","Stavanger","0008","Eiganes","MDG",47,0,47
"1103","Stavanger","0008","Eiganes","PP",45,0,45
"1103","Stavanger","0009","Kampen","A",672,0,672
"1103","Stavanger","0009","Kampen","SV",106,0,106
"1103","Stavanger","0009","Kampen","RØDT",41,0,41
"1103","Stavanger","0009","Kampen","SP",33,0,33
"1103","Stavanger","0009","Kampen","KRF",91,0,91
"1103","Stavanger","0009","Kampen","V",183,0,183
"1103","Stavanger","0009","Kampen","H",736,0,736
"1103","Stavanger","0009","Kampen","FRP",275,0,275
"1103","Stavanger","0009","Kampen","DEMN",3,0,3
"1103","Stavanger","0009","Kampen","MDG",37,0,37
"1103","Stavanger","0009","Kampen","PP",48,0,48
"1103","Stavanger","0011","Austre Åmøy","A",21,0,21
"1103","Stavanger","0011","Austre Åmøy","SV",1,0,1
"1103","Stavanger","0011","Austre Åmøy","RØDT",1,0,1
"1103","Stavanger","0011","Austre Åmøy","SP",10,0,10
"1103","Stavanger","0011","Austre Åmøy","KRF",13,0,13
"1103","Stavanger","0011","Austre Åmøy","V",10,0,10
"1103","Stavanger","0011","Austre Åmøy","H",41,0,41
"1103","Stavanger","0011","Austre Åmøy","FRP",22,0,22
"1103","Stavanger","0011","Austre Åmøy","MDG",2,0,2
"1103","Stavanger","0011","Austre Åmøy","PP",1,0,1
"1103","Stavanger","0013","Roaldsøy","A",140,0,140
"1103","Stavanger","0013","Roaldsøy","SV",23,0,23
"1103","Stavanger","0013","Roaldsøy","RØDT",4,0,4
"1103","Stavanger","0013","Roaldsøy","SP",7,0,7
"1103","Stavanger","0013","Roaldsøy","KRF",17,0,17
"1103","Stavanger","0013","Roaldsøy","V",20,0,20
"1103","Stavanger","0013","Roaldsøy","H",235,0,235
"1103","Stavanger","0013","Roaldsøy","FRP",109,0,109
"1103","Stavanger","0013","Roaldsøy","DEMN",2,0,2
"1103","Stavanger","0013","Roaldsøy","MDG",2,0,2
"1103","Stavanger","0013","Roaldsøy","PP",10,0,10
"1103","Stavanger","0014","Vassøy","A",87,0,87
"1103","Stavanger","0014","Vassøy","SV",17,0,17
"1103","Stavanger","0014","Vassøy","RØDT",13,0,13
"1103","Stavanger","0014","Vassøy","SP",9,0,9
"1103","Stavanger","0014","Vassøy","KRF",26,0,26
"1103","Stavanger","0014","Vassøy","V",18,0,18
"1103","Stavanger","0014","Vassøy","H",104,0,104
"1103","Stavanger","0014","Vassøy","FRP",59,0,59
"1103","Stavanger","0014","Vassøy","MDG",6,0,6
"1103","Stavanger","0014","Vassøy","PP",18,0,18
"1103","Stavanger","0016","Gausel","A",1087,0,1087
"1103","Stavanger","0016","Gausel","SV",95,0,95
"1103","Stavanger","0016","Gausel","RØDT",32,0,32
"1103","Stavanger","0016","Gausel","SP",65,0,65
"1103","Stavanger","0016","Gausel","KRF",215,0,215
"1103","Stavanger","0016","Gausel","V",225,0,225
"1103","Stavanger","0016","Gausel","H",1572,0,1572
"1103","Stavanger","0016","Gausel","FRP",559,0,559
"1103","Stavanger","0016","Gausel","DEMN",7,0,7
"1103","Stavanger","0016","Gausel","MDG",28,0,28
"1103","Stavanger","0016","Gausel","PP",68,0,68
"1103","Stavanger","0017","Hinna","A",688,0,688
"1103","Stavanger","0017","Hinna","SV",63,0,63
"1103","Stavanger","0017","Hinna","RØDT",21,0,21
"1103","Stavanger","0017","Hinna","SP",50,0,50
"1103","Stavanger","0017","Hinna","KRF",206,0,206
"1103","Stavanger","0017","Hinna","V",171,0,171
"1103","Stavanger","0017","Hinna","H",1123,0,1123
"1103","Stavanger","0017","Hinna","FRP",369,0,369
"1103","Stavanger","0017","Hinna","DEMN",5,0,5
"1103","Stavanger","0017","Hinna","MDG",29,0,29
"1103","Stavanger","0017","Hinna","PP",34,0,34
"1103","Stavanger","0018","Vaulen","A",652,0,652
"1103","Stavanger","0018","Vaulen","SV",64,0,64
"1103","Stavanger","0018","Vaulen","RØDT",22,0,22
"1103","Stavanger","0018","Vaulen","SP",38,0,38
"1103","Stavanger","0018","Vaulen","KRF",163,0,163
"1103","Stavanger","0018","Vaulen","V",194,0,194
"1103","Stavanger","0018","Vaulen","H",1010,0,1010
"1103","Stavanger","0018","Vaulen","FRP",383,0,383
"1103","Stavanger","0018","Vaulen","DEMN",2,0,2
"1103","Stavanger","0018","Vaulen","MDG",25,0,25
"1103","Stavanger","0018","Vaulen","PP",70,0,70
"1103","Stavanger","0019","Kvaleberg","A",768,0,768
"1103","Stavanger","0019","Kvaleberg","SV",97,0,97
"1103","Stavanger","0019","Kvaleberg","RØDT",24,0,24
"1103","Stavanger","0019","Kvaleberg","SP",53,0,53
"1103","Stavanger","0019","Kvaleberg","KRF",262,0,262
"1103","Stavanger","0019","Kvaleberg","V",176,0,176
"1103","Stavanger","0019","Kvaleberg","H",663,0,663
"1103","Stavanger","0019","Kvaleberg","FRP",319,0,319
"1103","Stavanger","0019","Kvaleberg","DEMN",3,0,3
"1103","Stavanger","0019","Kvaleberg","MDG",34,0,34
"1103","Stavanger","0019","Kvaleberg","PP",76,0,76
"1103","Stavanger","0020","Tjensvoll","A",893,0,893
"1103","Stavanger","0020","Tjensvoll","SV",129,0,129
"1103","Stavanger","0020","Tjensvoll","RØDT",47,0,47
"1103","Stavanger","0020","Tjensvoll","SP",57,0,57
"1103","Stavanger","0020","Tjensvoll","KRF",224,0,224
"1103","Stavanger","0020","Tjensvoll","V",205,0,205
"1103","Stavanger","0020","Tjensvoll","H",753,0,753
"1103","Stavanger","0020","Tjensvoll","FRP",268,0,268
"1103","Stavanger","0020","Tjensvoll","DEMN",3,0,3
"1103","Stavanger","0020","Tjensvoll","MDG",47,0,47
"1103","Stavanger","0020","Tjensvoll","PP",46,0,46
"1103","Stavanger","0021","Stokka","A",601,0,601
"1103","Stavanger","0021","Stokka","SV",71,0,71
"1103","Stavanger","0021","Stokka","RØDT",25,0,25
"1103","Stavanger","0021","Stokka","SP",46,0,46
"1103","Stavanger","0021","Stokka","KRF",151,0,151
"1103","Stavanger","0021","Stokka","V",191,0,191
"1103","Stavanger","0021","Stokka","H",994,0,994
"1103","Stavanger","0021","Stokka","FRP",262,0,262
"1103","Stavanger","0021","Stokka","DEMN",1,0,1
"1103","Stavanger","0021","Stokka","MDG",40,0,40
"1103","Stavanger","0021","Stokka","PP",41,0,41
"1103","Stavanger","0022","Madlamark","A",858,0,858
"1103","Stavanger","0022","Madlamark","SV",99,0,99
"1103","Stavanger","0022","Madlamark","RØDT",35,0,35
"1103","Stavanger","0022","Madlamark","SP",68,0,68
"1103","Stavanger","0022","Madlamark","KRF",224,0,224
"1103","Stavanger","0022","Madlamark","V",222,0,222
"1103","Stavanger","0022","Madlamark","H",1313,0,1313
"1103","Stavanger","0022","Madlamark","FRP",343,0,343
"1103","Stavanger","0022","Madlamark","DEMN",4,0,4
"1103","Stavanger","0022","Madlamark","MDG",34,0,34
"1103","Stavanger","0022","Madlamark","PP",71,0,71
"1103","Stavanger","0023","Hafrsfjord","A",475,0,475
"1103","Stavanger","0023","Hafrsfjord","SV",46,0,46
"1103","Stavanger","0023","Hafrsfjord","RØDT",13,0,13
"1103","Stavanger","0023","Hafrsfjord","SP",49,0,49
"1103","Stavanger","0023","Hafrsfjord","KRF",125,0,125
"1103","Stavanger","0023","Hafrsfjord","V",74,0,74
"1103","Stavanger","0023","Hafrsfjord","H",683,0,683
"1103","Stavanger","0023","Hafrsfjord","FRP",284,0,284
"1103","Stavanger","0023","Hafrsfjord","DEMN",7,0,7
"1103","Stavanger","0023","Hafrsfjord","MDG",13,0,13
"1103","Stavanger","0023","Hafrsfjord","PP",45,0,45
"1103","Stavanger","0024","Kvernevik","A",585,0,585
"1103","Stavanger","0024","Kvernevik","SV",45,0,45
"1103","Stavanger","0024","Kvernevik","RØDT",20,0,20
"1103","Stavanger","0024","Kvernevik","SP",45,0,45
"1103","Stavanger","0024","Kvernevik","KRF",105,0,105
"1103","Stavanger","0024","Kvernevik","V",123,0,123
"1103","Stavanger","0024","Kvernevik","H",484,0,484
"1103","Stavanger","0024","Kvernevik","FRP",416,0,416
"1103","Stavanger","0024","Kvernevik","DEMN",3,0,3
"1103","Stavanger","0024","Kvernevik","MDG",12,0,12
"1103","Stavanger","0024","Kvernevik","PP",59,0,59
"1103","Stavanger","0025","Sunde","A",519,0,519
"1103","Stavanger","0025","Sunde","SV",45,0,45
"1103","Stavanger","0025","Sunde","RØDT",13,0,13
"1103","Stavanger","0025","Sunde","SP",82,0,82
"1103","Stavanger","0025","Sunde","KRF",132,0,132
"1103","Stavanger","0025","Sunde","V",98,0,98
"1103","Stavanger","0025","Sunde","H",662,0,662
"1103","Stavanger","0025","Sunde","FRP",273,0,273
"1103","Stavanger","0025","Sunde","DEMN",1,0,1
"1103","Stavanger","0025","Sunde","MDG",16,0,16
"1103","Stavanger","0025","Sunde","PP",28,0,28
"1103","Stavanger","0026","Indre Tasta","A",732,0,732
"1103","Stavanger","0026","Indre Tasta","SV",86,0,86
"1103","Stavanger","0026","Indre Tasta","RØDT",20,0,20
"1103","Stavanger","0026","Indre Tasta","SP",46,0,46
"1103","Stavanger","0026","Indre Tasta","KRF",128,0,128
"1103","Stavanger","0026","Indre Tasta","V",210,0,210
"1103","Stavanger","0026","Indre Tasta","H",780,0,780
"1103","Stavanger","0026","Indre Tasta","FRP",334,0,334
"1103","Stavanger","0026","Indre Tasta","MDG",37,0,37
"1103","Stavanger","0026","Indre Tasta","PP",56,0,56
"1103","Stavanger","0027","Ytre Tasta","A",988,0,988
"1103","Stavanger","0027","Ytre Tasta","SV",95,0,95
"1103","Stavanger","0027","Ytre Tasta","RØDT",44,0,44
"1103","Stavanger","0027","Ytre Tasta","SP",72,0,72
"1103","Stavanger","0027","Ytre Tasta","KRF",226,0,226
"1103","Stavanger","0027","Ytre Tasta","V",270,0,270
"1103","Stavanger","0027","Ytre Tasta","H",1153,0,1153
"1103","Stavanger","0027","Ytre Tasta","FRP",521,0,521
"1103","Stavanger","0027","Ytre Tasta","DEMN",3,0,3
"1103","Stavanger","0027","Ytre Tasta","MDG",27,0,27
"1103","Stavanger","0027","Ytre Tasta","PP",70,0,70
"1106","Haugesund","0000",,"A",3504,946,4450
"1106","Haugesund","0000",,"SV",286,104,390
"1106","Haugesund","0000",,"RØDT",66,18,84
"1106","Haugesund","0000",,"SP",147,28,175
"1106","Haugesund","0000",,"KRF",694,174,868
"1106","Haugesund","0000",,"V",670,173,843
"1106","Haugesund","0000",,"H",4716,1217,5933
"1106","Haugesund","0000",,"FRP",1471,420,1891
"1106","Haugesund","0000",,"MDG",79,17,96
"1106","Haugesund","0000",,"PP",627,167,794
"1111","Sokndal","0000",,"A",419,97,516
"1111","Sokndal","0000",,"SP",85,14,99
"1111","Sokndal","0000",,"KRF",257,80,337
"1111","Sokndal","0000",,"V",100,28,128
"1111","Sokndal","0000",,"H",278,44,322
"1111","Sokndal","0000",,"FRP",273,46,319
"1112","Lund","0000",,"A",352,147,499
"1112","Lund","0000",,"SP",145,48,193
"1112","Lund","0000",,"KRF",246,115,361
"1112","Lund","0000",,"V",57,18,75
"1112","Lund","0000",,"H",158,69,227
"1112","Lund","0000",,"FRP",189,83,272
"1114","Bjerkreim","0000",,"A",124,26,150
"1114","Bjerkreim","0000",,"SP",269,35,304
"1114","Bjerkreim","0000",,"KRF",218,31,249
"1114","Bjerkreim","0000",,"V",61,15,76
"1114","Bjerkreim","0000",,"H",416,61,477
"1114","Bjerkreim","0000",,"FRP",85,19,104
"1119","Hå","0000",,"A",496,103,599
"1119","Hå","0000",,"SV",116,28,144
"1119","Hå","0000",,"SP",673,97,770
"1119","Hå","0000",,"KRF",1170,215,1385
"1119","Hå","0000",,"V",91,23,114
"1119","Hå","0000",,"H",1428,158,1586
"1119","Hå","0000",,"FRP",633,90,723
"1119","Hå","0000",,"KSP",98,16,114
"1119","Hå","0000",,"NÆ",2243,376,2619
"1120","Klepp","0000",,"A",977,254,1231
"1120","Klepp","0000",,"SV",82,31,113
"1120","Klepp","0000",,"RØDT",26,4,30
"1120","Klepp","0000",,"SP",701,111,812
"1120","Klepp","0000",,"KRF",1049,191,1240
"1120","Klepp","0000",,"V",282,64,346
"1120","Klepp","0000",,"H",2194,386,2580
"1120","Klepp","0000",,"FRP",1103,213,1316
"1121","Time","0000",,"A",1013,235,1248
"1121","Time","0000",,"SV",233,60,293
"1121","Time","0000",,"SP",933,119,1052
"1121","Time","0000",,"KRF",1010,189,1199
"1121","Time","0000",,"V",357,71,428
"1121","Time","0000",,"H",2522,356,2878
"1121","Time","0000",,"FRP",829,131,960
"1121","Time","0000",,"MDG",99,27,126
"1122","Gjesdal","0000",,"A",872,198,1070
"1122","Gjesdal","0000",,"SV",103,31,134
"1122","Gjesdal","0000",,"SP",307,69,376
"1122","Gjesdal","0000",,"KRF",1044,258,1302
"1122","Gjesdal","0000",,"V",129,34,163
"1122","Gjesdal","0000",,"H",910,170,1080
"1122","Gjesdal","0000",,"FRP",889,139,1028
"1124","Sola","0000",,"A",1411,389,1800
"1124","Sola","0000",,"SV",197,63,260
"1124","Sola","0000",,"SP",312,56,368
"1124","Sola","0000",,"KRF",899,205,1104
"1124","Sola","0000",,"V",374,74,448
"1124","Sola","0000",,"H",3283,697,3980
"1124","Sola","0000",,"FRP",1739,485,2224
"1124","Sola","0000",,"PP",257,91,348
"1124","Sola","0000",,"TAL",346,96,442
"1127","Randaberg","0000",,"A",1079,270,1349
"1127","Randaberg","0000",,"SV",70,25,95
"1127","Randaberg","0000",,"SP",308,60,368
"1127","Randaberg","0000",,"KRF",587,165,752
"1127","Randaberg","0000",,"V",218,47,265
"1127","Randaberg","0000",,"H",1185,274,1459
"1127","Randaberg","0000",,"FRP",513,152,665
"1129","Forsand","0000",,"A",100,20,120
"1129","Forsand","0000",,"SP",106,18,124
"1129","Forsand","0000",,"KRF",164,28,192
"1129","Forsand","0000",,"H",127,34,161
"1129","Forsand","0000",,"FRP",41,6,47
"1130","Strand","0000",,"A",1864,348,2212
"1130","Strand","0000",,"SV",116,28,144
"1130","Strand","0000",,"SP",317,43,360
"1130","Strand","0000",,"KRF",758,161,919
"1130","Strand","0000",,"V",143,30,173
"1130","Strand","0000",,"H",776,140,916
"1130","Strand","0000",,"FRP",556,110,666
"1130","Strand","0000",,"MDG",15,7,22
"1133","Hjelmeland","0000",,"A",155,32,187
"1133","Hjelmeland","0000",,"SV",39,13,52
"1133","Hjelmeland","0000",,"SP",322,47,369
"1133","Hjelmeland","0000",,"KRF",251,51,302
"1133","Hjelmeland","0000",,"V",47,7,54
"1133","Hjelmeland","0000",,"H",281,71,352
"1133","Hjelmeland","0000",,"FRP",76,23,99
"1133","Hjelmeland","0000",,"KYST",13,2,15
"1134","Suldal","0000",,"A",377,83,460
"1134","Suldal","0000",,"SV",109,45,154
"1134","Suldal","0000",,"SP",535,71,606
"1134","Suldal","0000",,"KRF",238,48,286
"1134","Suldal","0000",,"V",145,20,165
"1134","Suldal","0000",,"H",141,18,159
"1134","Suldal","0000",,"FRP",107,23,130
"1135","Sauda","0000",,"A",909,241,1150
"1135","Sauda","0000",,"SV",87,30,117
"1135","Sauda","0000",,"SP",174,43,217
"1135","Sauda","0000",,"KRF",131,42,173
"1135","Sauda","0000",,"V",80,23,103
"1135","Sauda","0000",,"H",502,104,606
"1135","Sauda","0000",,"FRP",120,55,175
"1141","Finnøy","0000",,"A",172,21,193
"1141","Finnøy","0000",,"SV",41,10,51
"1141","Finnøy","0000",,"SP",249,43,292
"1141","Finnøy","0000",,"KRF",344,63,407
"1141","Finnøy","0000",,"V",259,33,292
"1141","Finnøy","0000",,"H",186,45,231
"1141","Finnøy","0000",,"FRP",89,20,109
"1142","Rennesøy","0000",,"A",241,45,286
"1142","Rennesøy","0000",,"SV",66,14,80
"1142","Rennesøy","0000",,"SP",401,48,449
"1142","Rennesøy","0000",,"KRF",236,42,278
"1142","Rennesøy","0000",,"H",673,67,740
"1142","Rennesøy","0000",,"FRP",269,38,307
"1144","Kvitsøy","0000",,"FRP",42,12,54
"1144","Kvitsøy","0000",,"ATPG",140,20,160
"1144","Kvitsøy","0000",,"KRFFLFB",98,6,104
"1145","Bokn","0000",,"A",130,29,159
"1145","Bokn","0000",,"SP",119,16,135
"1145","Bokn","0000",,"KRF",33,3,36
"1145","Bokn","0000",,"H",108,18,126
"1146","Tysvær","0000",,"A",786,293,1079
"1146","Tysvær","0000",,"SV",70,33,103
"1146","Tysvær","0000",,"SP",379,100,479
"1146","Tysvær","0000",,"KRF",459,128,587
"1146","Tysvær","0000",,"V",193,54,247
"1146","Tysvær","0000",,"H",1223,308,1531
"1146","Tysvær","0000",,"FRP",432,161,593
"1149","Karmøy","0000",,"A",3499,855,4354
"1149","Karmøy","0000",,"SV",287,96,383
"1149","Karmøy","0000",,"RØDT",35,14,49
"1149","Karmøy","0000",,"SP",358,58,416
"1149","Karmøy","0000",,"KRF",2491,559,3050
"1149","Karmøy","0000",,"V",454,113,567
"1149","Karmøy","0000",,"H",3883,864,4747
"1149","Karmøy","0000",,"FRP",3353,944,4297
"1149","Karmøy","0000",,"KSP",98,23,121
"1149","Karmøy","0000",,"PP",282,63,345
"1151","Utsira","0000",,"FLUT",63,31,94
"1151","Utsira","0000",,"UNGLIST",14,10,24
"1160","Vindafjord","0000",,"A",545,82,627
"1160","Vindafjord","0000",,"SV",116,40,156
"1160","Vindafjord","0000",,"SP",1013,175,1188
"1160","Vindafjord","0000",,"KRF",348,56,404
"1160","Vindafjord","0000",,"H",700,93,793
"1160","Vindafjord","0000",,"FRP",345,63,408
"1160","Vindafjord","0000",,"KRLB",148,15,163
"1201","Bergen","FORH","Forhånd ikke kretsfordelt","A",0,115,115
"1201","Bergen","FORH","Forhånd ikke kretsfordelt","SV",0,34,34
"1201","Bergen","FORH","Forhånd ikke kretsfordelt","RØDT",0,19,19
"1201","Bergen","FORH","Forhånd ikke kretsfordelt","SP",0,6,6
"1201","Bergen","FORH","Forhånd ikke kretsfordelt","KRF",0,28,28
"1201","Bergen","FORH","Forhånd ikke kretsfordelt","V",0,69,69
"1201","Bergen","FORH","Forhånd ikke kretsfordelt","H",0,135,135
"1201","Bergen","FORH","Forhånd ikke kretsfordelt","FRP",0,35,35
"1201","Bergen","FORH","Forhånd ikke kretsfordelt","DEMN",0,1,1
"1201","Bergen","FORH","Forhånd ikke kretsfordelt","KSP",0,3,3
"1201","Bergen","FORH","Forhånd ikke kretsfordelt","MDG",0,14,14
"1201","Bergen","FORH","Forhånd ikke kretsfordelt","NKP",0,4,4
"1201","Bergen","FORH","Forhånd ikke kretsfordelt","PP",0,3,3
"1201","Bergen","FORH","Forhånd ikke kretsfordelt","BYLUFT",0,3,3
"1201","Bergen","FREM","Fremmede ikke kretsfordelt","A",1122,0,1122
"1201","Bergen","FREM","Fremmede ikke kretsfordelt","SV",246,0,246
"1201","Bergen","FREM","Fremmede ikke kretsfordelt","RØDT",207,0,207
"1201","Bergen","FREM","Fremmede ikke kretsfordelt","SP",55,0,55
"1201","Bergen","FREM","Fremmede ikke kretsfordelt","KRF",208,0,208
"1201","Bergen","FREM","Fremmede ikke kretsfordelt","V",466,0,466
"1201","Bergen","FREM","Fremmede ikke kretsfordelt","H",1255,0,1255
"1201","Bergen","FREM","Fremmede ikke kretsfordelt","FRP",275,0,275
"1201","Bergen","FREM","Fremmede ikke kretsfordelt","DEMN",9,0,9
"1201","Bergen","FREM","Fremmede ikke kretsfordelt","KSP",6,0,6
"1201","Bergen","FREM","Fremmede ikke kretsfordelt","KYST",4,0,4
"1201","Bergen","FREM","Fremmede ikke kretsfordelt","MDG",157,0,157
"1201","Bergen","FREM","Fremmede ikke kretsfordelt","NKP",4,0,4
"1201","Bergen","FREM","Fremmede ikke kretsfordelt","PP",11,0,11
"1201","Bergen","FREM","Fremmede ikke kretsfordelt","BYLUFT",100,0,100
"1201","Bergen","VALG","Valgting ikke kretsfordelt","A",27,0,27
"1201","Bergen","VALG","Valgting ikke kretsfordelt","SV",7,0,7
"1201","Bergen","VALG","Valgting ikke kretsfordelt","RØDT",2,0,2
"1201","Bergen","VALG","Valgting ikke kretsfordelt","SP",1,0,1
"1201","Bergen","VALG","Valgting ikke kretsfordelt","KRF",8,0,8
"1201","Bergen","VALG","Valgting ikke kretsfordelt","V",4,0,4
"1201","Bergen","VALG","Valgting ikke kretsfordelt","H",30,0,30
"1201","Bergen","VALG","Valgting ikke kretsfordelt","FRP",6,0,6
"1201","Bergen","VALG","Valgting ikke kretsfordelt","KSP",2,0,2
"1201","Bergen","VALG","Valgting ikke kretsfordelt","BYLUFT",1,0,1
"1201","Bergen","0135","Ytre Arna","A",338,96,434
"1201","Bergen","0135","Ytre Arna","SV",35,9,44
"1201","Bergen","0135","Ytre Arna","RØDT",19,3,22
"1201","Bergen","0135","Ytre Arna","SP",13,2,15
"1201","Bergen","0135","Ytre Arna","KRF",121,15,136
"1201","Bergen","0135","Ytre Arna","V",37,9,46
"1201","Bergen","0135","Ytre Arna","H",303,54,357
"1201","Bergen","0135","Ytre Arna","FRP",141,29,170
"1201","Bergen","0135","Ytre Arna","DEMN",3,1,4
"1201","Bergen","0135","Ytre Arna","KSP",4,0,4
"1201","Bergen","0135","Ytre Arna","KYST",8,0,8
"1201","Bergen","0135","Ytre Arna","MDG",10,2,12
"1201","Bergen","0135","Ytre Arna","NKP",1,0,1
"1201","Bergen","0135","Ytre Arna","PP",5,0,5
"1201","Bergen","0135","Ytre Arna","BYLUFT",3,2,5
"1201","Bergen","0136","Indre Arna","A",485,206,691
"1201","Bergen","0136","Indre Arna","SV",43,19,62
"1201","Bergen","0136","Indre Arna","RØDT",32,17,49
"1201","Bergen","0136","Indre Arna","SP",27,9,36
"1201","Bergen","0136","Indre Arna","KRF",109,49,158
"1201","Bergen","0136","Indre Arna","V",69,21,90
"1201","Bergen","0136","Indre Arna","H",352,106,458
"1201","Bergen","0136","Indre Arna","FRP",170,44,214
"1201","Bergen","0136","Indre Arna","DEMN",2,1,3
"1201","Bergen","0136","Indre Arna","KSP",4,2,6
"1201","Bergen","0136","Indre Arna","KYST",3,1,4
"1201","Bergen","0136","Indre Arna","MDG",16,9,25
"1201","Bergen","0136","Indre Arna","NKP",0,2,2
"1201","Bergen","0136","Indre Arna","PP",8,4,12
"1201","Bergen","0136","Indre Arna","BYLUFT",4,1,5
"1201","Bergen","0137","Garnes","A",494,155,649
"1201","Bergen","0137","Garnes","SV",42,12,54
"1201","Bergen","0137","Garnes","RØDT",19,6,25
"1201","Bergen","0137","Garnes","SP",33,4,37
"1201","Bergen","0137","Garnes","KRF",83,27,110
"1201","Bergen","0137","Garnes","V",61,14,75
"1201","Bergen","0137","Garnes","H",448,124,572
"1201","Bergen","0137","Garnes","FRP",133,48,181
"1201","Bergen","0137","Garnes","DEMN",1,0,1
"1201","Bergen","0137","Garnes","KSP",5,1,6
"1201","Bergen","0137","Garnes","KYST",2,0,2
"1201","Bergen","0137","Garnes","MDG",10,3,13
"1201","Bergen","0137","Garnes","NKP",1,0,1
"1201","Bergen","0137","Garnes","PP",3,6,9
"1201","Bergen","0137","Garnes","BYLUFT",2,1,3
"1201","Bergen","0139","Lone","A",339,59,398
"1201","Bergen","0139","Lone","SV",22,11,33
"1201","Bergen","0139","Lone","RØDT",19,8,27
"1201","Bergen","0139","Lone","SP",39,10,49
"1201","Bergen","0139","Lone","KRF",106,19,125
"1201","Bergen","0139","Lone","V",49,5,54
"1201","Bergen","0139","Lone","H",347,59,406
"1201","Bergen","0139","Lone","FRP",197,40,237
"1201","Bergen","0139","Lone","DEMN",0,2,2
"1201","Bergen","0139","Lone","KSP",6,1,7
"1201","Bergen","0139","Lone","KYST",5,1,6
"1201","Bergen","0139","Lone","MDG",11,1,12
"1201","Bergen","0139","Lone","NKP",0,1,1
"1201","Bergen","0139","Lone","PP",8,2,10
"1201","Bergen","0139","Lone","BYLUFT",3,0,3
"1201","Bergen","0201","Bergen rådhus","A",574,428,1002
"1201","Bergen","0201","Bergen rådhus","SV",176,135,311
"1201","Bergen","0201","Bergen rådhus","RØDT",181,107,288
"1201","Bergen","0201","Bergen rådhus","SP",24,22,46
"1201","Bergen","0201","Bergen rådhus","KRF",86,80,166
"1201","Bergen","0201","Bergen rådhus","V",296,177,473
"1201","Bergen","0201","Bergen rådhus","H",670,483,1153
"1201","Bergen","0201","Bergen rådhus","FRP",159,119,278
"1201","Bergen","0201","Bergen rådhus","DEMN",7,3,10
"1201","Bergen","0201","Bergen rådhus","KSP",7,4,11
"1201","Bergen","0201","Bergen rådhus","KYST",3,0,3
"1201","Bergen","0201","Bergen rådhus","MDG",132,65,197
"1201","Bergen","0201","Bergen rådhus","NKP",3,1,4
"1201","Bergen","0201","Bergen rådhus","PP",5,8,13
"1201","Bergen","0201","Bergen rådhus","BYLUFT",85,43,128
"1201","Bergen","0202","Møhlenpris","A",438,222,660
"1201","Bergen","0202","Møhlenpris","SV",168,67,235
"1201","Bergen","0202","Møhlenpris","RØDT",129,59,188
"1201","Bergen","0202","Møhlenpris","SP",12,9,21
"1201","Bergen","0202","Møhlenpris","KRF",33,21,54
"1201","Bergen","0202","Møhlenpris","V",217,88,305
"1201","Bergen","0202","Møhlenpris","H",356,146,502
"1201","Bergen","0202","Møhlenpris","FRP",89,44,133
"1201","Bergen","0202","Møhlenpris","DEMN",4,1,5
"1201","Bergen","0202","Møhlenpris","KSP",4,2,6
"1201","Bergen","0202","Møhlenpris","KYST",1,0,1
"1201","Bergen","0202","Møhlenpris","MDG",84,33,117
"1201","Bergen","0202","Møhlenpris","NKP",8,0,8
"1201","Bergen","0202","Møhlenpris","PP",5,4,9
"1201","Bergen","0202","Møhlenpris","BYLUFT",79,26,105
"1201","Bergen","0203","Nordnes","A",472,195,667
"1201","Bergen","0203","Nordnes","SV",139,62,201
"1201","Bergen","0203","Nordnes","RØDT",140,57,197
"1201","Bergen","0203","Nordnes","SP",14,13,27
"1201","Bergen","0203","Nordnes","KRF",49,19,68
"1201","Bergen","0203","Nordnes","V",230,75,305
"1201","Bergen","0203","Nordnes","H",484,203,687
"1201","Bergen","0203","Nordnes","FRP",109,82,191
"1201","Bergen","0203","Nordnes","DEMN",1,1,2
"1201","Bergen","0203","Nordnes","KSP",0,2,2
"1201","Bergen","0203","Nordnes","KYST",2,1,3
"1201","Bergen","0203","Nordnes","MDG",64,28,92
"1201","Bergen","0203","Nordnes","NKP",1,2,3
"1201","Bergen","0203","Nordnes","PP",2,5,7
"1201","Bergen","0203","Nordnes","BYLUFT",51,26,77
"1201","Bergen","0204","Haukeland","A",405,167,572
"1201","Bergen","0204","Haukeland","SV",105,51,156
"1201","Bergen","0204","Haukeland","RØDT",75,28,103
"1201","Bergen","0204","Haukeland","SP",29,9,38
"1201","Bergen","0204","Haukeland","KRF",130,54,184
"1201","Bergen","0204","Haukeland","V",232,75,307
"1201","Bergen","0204","Haukeland","H",853,382,1235
"1201","Bergen","0204","Haukeland","FRP",102,49,151
"1201","Bergen","0204","Haukeland","DEMN",2,0,2
"1201","Bergen","0204","Haukeland","KSP",2,1,3
"1201","Bergen","0204","Haukeland","KYST",2,0,2
"1201","Bergen","0204","Haukeland","MDG",62,14,76
"1201","Bergen","0204","Haukeland","NKP",2,1,3
"1201","Bergen","0204","Haukeland","PP",5,3,8
"1201","Bergen","0204","Haukeland","BYLUFT",45,13,58
"1201","Bergen","0218","Hellen","A",690,253,943
"1201","Bergen","0218","Hellen","SV",103,41,144
"1201","Bergen","0218","Hellen","RØDT",78,37,115
"1201","Bergen","0218","Hellen","SP",24,7,31
"1201","Bergen","0218","Hellen","KRF",118,39,157
"1201","Bergen","0218","Hellen","V",188,51,239
"1201","Bergen","0218","Hellen","H",951,306,1257
"1201","Bergen","0218","Hellen","FRP",193,83,276
"1201","Bergen","0218","Hellen","DEMN",6,1,7
"1201","Bergen","0218","Hellen","KSP",4,1,5
"1201","Bergen","0218","Hellen","KYST",2,2,4
"1201","Bergen","0218","Hellen","MDG",54,29,83
"1201","Bergen","0218","Hellen","NKP",0,2,2
"1201","Bergen","0218","Hellen","PP",12,5,17
"1201","Bergen","0218","Hellen","BYLUFT",35,9,44
"1201","Bergen","0219","Rothaugen","A",900,413,1313
"1201","Bergen","0219","Rothaugen","SV",269,111,380
"1201","Bergen","0219","Rothaugen","RØDT",224,77,301
"1201","Bergen","0219","Rothaugen","SP",28,20,48
"1201","Bergen","0219","Rothaugen","KRF",99,47,146
"1201","Bergen","0219","Rothaugen","V",303,133,436
"1201","Bergen","0219","Rothaugen","H",927,432,1359
"1201","Bergen","0219","Rothaugen","FRP",217,109,326
"1201","Bergen","0219","Rothaugen","DEMN",7,1,8
"1201","Bergen","0219","Rothaugen","KSP",8,1,9
"1201","Bergen","0219","Rothaugen","KYST",4,5,9
"1201","Bergen","0219","Rothaugen","MDG",144,67,211
"1201","Bergen","0219","Rothaugen","NKP",5,4,9
"1201","Bergen","0219","Rothaugen","PP",8,15,23
"1201","Bergen","0219","Rothaugen","BYLUFT",78,24,102
"1201","Bergen","0340","Kringlebotn","A",416,151,567
"1201","Bergen","0340","Kringlebotn","SV",59,15,74
"1201","Bergen","0340","Kringlebotn","RØDT",32,11,43
"1201","Bergen","0340","Kringlebotn","SP",13,5,18
"1201","Bergen","0340","Kringlebotn","KRF",56,34,90
"1201","Bergen","0340","Kringlebotn","V",107,47,154
"1201","Bergen","0340","Kringlebotn","H",612,249,861
"1201","Bergen","0340","Kringlebotn","FRP",89,58,147
"1201","Bergen","0340","Kringlebotn","KSP",1,0,1
"1201","Bergen","0340","Kringlebotn","KYST",2,0,2
"1201","Bergen","0340","Kringlebotn","MDG",18,11,29
"1201","Bergen","0340","Kringlebotn","PP",8,2,10
"1201","Bergen","0340","Kringlebotn","BYLUFT",8,3,11
"1201","Bergen","0341","Ulsmåg","A",515,152,667
"1201","Bergen","0341","Ulsmåg","SV",51,15,66
"1201","Bergen","0341","Ulsmåg","RØDT",40,19,59
"1201","Bergen","0341","Ulsmåg","SP",52,6,58
"1201","Bergen","0341","Ulsmåg","KRF",121,47,168
"1201","Bergen","0341","Ulsmåg","V",96,23,119
"1201","Bergen","0341","Ulsmåg","H",622,197,819
"1201","Bergen","0341","Ulsmåg","FRP",215,86,301
"1201","Bergen","0341","Ulsmåg","DEMN",4,1,5
"1201","Bergen","0341","Ulsmåg","KSP",5,2,7
"1201","Bergen","0341","Ulsmåg","KYST",0,1,1
"1201","Bergen","0341","Ulsmåg","MDG",40,8,48
"1201","Bergen","0341","Ulsmåg","NKP",1,1,2
"1201","Bergen","0341","Ulsmåg","PP",15,7,22
"1201","Bergen","0341","Ulsmåg","BYLUFT",15,0,15
"1201","Bergen","0344","Kaland","A",268,109,377
"1201","Bergen","0344","Kaland","SV",17,9,26
"1201","Bergen","0344","Kaland","RØDT",26,5,31
"1201","Bergen","0344","Kaland","SP",64,15,79
"1201","Bergen","0344","Kaland","KRF",63,20,83
"1201","Bergen","0344","Kaland","V",52,18,70
"1201","Bergen","0344","Kaland","H",457,131,588
"1201","Bergen","0344","Kaland","FRP",177,50,227
"1201","Bergen","0344","Kaland","DEMN",5,0,5
"1201","Bergen","0344","Kaland","KSP",2,1,3
"1201","Bergen","0344","Kaland","KYST",7,0,7
"1201","Bergen","0344","Kaland","MDG",21,6,27
"1201","Bergen","0344","Kaland","PP",3,6,9
"1201","Bergen","0345","Kirkevoll","A",439,126,565
"1201","Bergen","0345","Kirkevoll","SV",55,29,84
"1201","Bergen","0345","Kirkevoll","RØDT",33,10,43
"1201","Bergen","0345","Kirkevoll","SP",52,13,65
"1201","Bergen","0345","Kirkevoll","KRF",94,35,129
"1201","Bergen","0345","Kirkevoll","V",115,34,149
"1201","Bergen","0345","Kirkevoll","H",872,258,1130
"1201","Bergen","0345","Kirkevoll","FRP",253,69,322
"1201","Bergen","0345","Kirkevoll","DEMN",6,2,8
"1201","Bergen","0345","Kirkevoll","KYST",4,1,5
"1201","Bergen","0345","Kirkevoll","MDG",24,7,31
"1201","Bergen","0345","Kirkevoll","NKP",1,0,1
"1201","Bergen","0345","Kirkevoll","PP",8,5,13
"1201","Bergen","0345","Kirkevoll","BYLUFT",6,4,10
"1201","Bergen","0348","Skjold","A",609,317,926
"1201","Bergen","0348","Skjold","SV",65,43,108
"1201","Bergen","0348","Skjold","RØDT",53,27,80
"1201","Bergen","0348","Skjold","SP",26,12,38
"1201","Bergen","0348","Skjold","KRF",143,59,202
"1201","Bergen","0348","Skjold","V",174,64,238
"1201","Bergen","0348","Skjold","H",1170,552,1722
"1201","Bergen","0348","Skjold","FRP",203,111,314
"1201","Bergen","0348","Skjold","DEMN",28,11,39
"1201","Bergen","0348","Skjold","KSP",7,1,8
"1201","Bergen","0348","Skjold","KYST",1,1,2
"1201","Bergen","0348","Skjold","MDG",48,15,63
"1201","Bergen","0348","Skjold","NKP",0,1,1
"1201","Bergen","0348","Skjold","PP",12,7,19
"1201","Bergen","0348","Skjold","BYLUFT",24,5,29
"1201","Bergen","0349","Midtun","A",378,171,549
"1201","Bergen","0349","Midtun","SV",47,26,73
"1201","Bergen","0349","Midtun","RØDT",29,10,39
"1201","Bergen","0349","Midtun","SP",15,4,19
"1201","Bergen","0349","Midtun","KRF",98,37,135
"1201","Bergen","0349","Midtun","V",97,46,143
"1201","Bergen","0349","Midtun","H",527,217,744
"1201","Bergen","0349","Midtun","FRP",110,60,170
"1201","Bergen","0349","Midtun","DEMN",2,1,3
"1201","Bergen","0349","Midtun","KSP",2,2,4
"1201","Bergen","0349","Midtun","KYST",1,0,1
"1201","Bergen","0349","Midtun","MDG",17,8,25
"1201","Bergen","0349","Midtun","PP",4,3,7
"1201","Bergen","0349","Midtun","BYLUFT",5,4,9
"1201","Bergen","0351","Hop","A",203,75,278
"1201","Bergen","0351","Hop","SV",38,14,52
"1201","Bergen","0351","Hop","RØDT",20,9,29
"1201","Bergen","0351","Hop","SP",6,6,12
"1201","Bergen","0351","Hop","KRF",27,20,47
"1201","Bergen","0351","Hop","V",116,42,158
"1201","Bergen","0351","Hop","H",566,259,825
"1201","Bergen","0351","Hop","FRP",79,36,115
"1201","Bergen","0351","Hop","DEMN",1,1,2
"1201","Bergen","0351","Hop","KYST",4,0,4
"1201","Bergen","0351","Hop","MDG",19,11,30
"1201","Bergen","0351","Hop","NKP",1,0,1
"1201","Bergen","0351","Hop","PP",2,1,3
"1201","Bergen","0351","Hop","BYLUFT",9,5,14
"1201","Bergen","0352","Paradis","A",165,69,234
"1201","Bergen","0352","Paradis","SV",34,6,40
"1201","Bergen","0352","Paradis","RØDT",27,11,38
"1201","Bergen","0352","Paradis","SP",10,4,14
"1201","Bergen","0352","Paradis","KRF",46,8,54
"1201","Bergen","0352","Paradis","V",85,29,114
"1201","Bergen","0352","Paradis","H",462,170,632
"1201","Bergen","0352","Paradis","FRP",62,28,90
"1201","Bergen","0352","Paradis","KSP",0,4,4
"1201","Bergen","0352","Paradis","KYST",1,0,1
"1201","Bergen","0352","Paradis","MDG",33,5,38
"1201","Bergen","0352","Paradis","NKP",1,0,1
"1201","Bergen","0352","Paradis","PP",1,4,5
"1201","Bergen","0352","Paradis","BYLUFT",15,2,17
"1201","Bergen","0377","Sædalen","A",338,85,423
"1201","Bergen","0377","Sædalen","SV",68,15,83
"1201","Bergen","0377","Sædalen","RØDT",34,5,39
"1201","Bergen","0377","Sædalen","SP",22,5,27
"1201","Bergen","0377","Sædalen","KRF",65,21,86
"1201","Bergen","0377","Sædalen","V",111,26,137
"1201","Bergen","0377","Sædalen","H",436,81,517
"1201","Bergen","0377","Sædalen","FRP",87,17,104
"1201","Bergen","0377","Sædalen","DEMN",10,0,10
"1201","Bergen","0377","Sædalen","MDG",24,5,29
"1201","Bergen","0377","Sædalen","NKP",0,1,1
"1201","Bergen","0377","Sædalen","PP",4,1,5
"1201","Bergen","0377","Sædalen","BYLUFT",22,2,24
"1201","Bergen","0409","Bønes","A",596,231,827
"1201","Bergen","0409","Bønes","SV",105,33,138
"1201","Bergen","0409","Bønes","RØDT",34,14,48
"1201","Bergen","0409","Bønes","SP",19,7,26
"1201","Bergen","0409","Bønes","KRF",210,78,288
"1201","Bergen","0409","Bønes","V",200,57,257
"1201","Bergen","0409","Bønes","H",1055,302,1357
"1201","Bergen","0409","Bønes","FRP",196,84,280
"1201","Bergen","0409","Bønes","DEMN",5,1,6
"1201","Bergen","0409","Bønes","KSP",4,1,5
"1201","Bergen","0409","Bønes","KYST",2,0,2
"1201","Bergen","0409","Bønes","MDG",24,10,34
"1201","Bergen","0409","Bønes","NKP",3,1,4
"1201","Bergen","0409","Bønes","PP",8,5,13
"1201","Bergen","0409","Bønes","BYLUFT",12,4,16
"1201","Bergen","0461","Lyshovden","A",487,238,725
"1201","Bergen","0461","Lyshovden","SV",50,15,65
"1201","Bergen","0461","Lyshovden","RØDT",27,21,48
"1201","Bergen","0461","Lyshovden","SP",8,4,12
"1201","Bergen","0461","Lyshovden","KRF",80,33,113
"1201","Bergen","0461","Lyshovden","V",85,36,121
"1201","Bergen","0461","Lyshovden","H",572,200,772
"1201","Bergen","0461","Lyshovden","FRP",175,108,283
"1201","Bergen","0461","Lyshovden","DEMN",1,0,1
"1201","Bergen","0461","Lyshovden","KSP",1,1,2
"1201","Bergen","0461","Lyshovden","KYST",2,3,5
"1201","Bergen","0461","Lyshovden","MDG",11,8,19
"1201","Bergen","0461","Lyshovden","NKP",1,0,1
"1201","Bergen","0461","Lyshovden","PP",18,3,21
"1201","Bergen","0461","Lyshovden","BYLUFT",5,5,10
"1201","Bergen","0462","Lynghaug","A",832,413,1245
"1201","Bergen","0462","Lynghaug","SV",103,43,146
"1201","Bergen","0462","Lynghaug","RØDT",68,30,98
"1201","Bergen","0462","Lynghaug","SP",34,8,42
"1201","Bergen","0462","Lynghaug","KRF",86,61,147
"1201","Bergen","0462","Lynghaug","V",118,43,161
"1201","Bergen","0462","Lynghaug","H",782,289,1071
"1201","Bergen","0462","Lynghaug","FRP",298,166,464
"1201","Bergen","0462","Lynghaug","DEMN",5,4,9
"1201","Bergen","0462","Lynghaug","KSP",4,3,7
"1201","Bergen","0462","Lynghaug","KYST",7,2,9
"1201","Bergen","0462","Lynghaug","MDG",30,11,41
"1201","Bergen","0462","Lynghaug","NKP",4,1,5
"1201","Bergen","0462","Lynghaug","PP",23,18,41
"1201","Bergen","0462","Lynghaug","BYLUFT",10,5,15
"1201","Bergen","0463","Ortun","A",723,351,1074
"1201","Bergen","0463","Ortun","SV",86,34,120
"1201","Bergen","0463","Ortun","RØDT",49,28,77
"1201","Bergen","0463","Ortun","SP",22,9,31
"1201","Bergen","0463","Ortun","KRF",127,61,188
"1201","Bergen","0463","Ortun","V",123,63,186
"1201","Bergen","0463","Ortun","H",876,389,1265
"1201","Bergen","0463","Ortun","FRP",254,148,402
"1201","Bergen","0463","Ortun","DEMN",8,1,9
"1201","Bergen","0463","Ortun","KSP",7,1,8
"1201","Bergen","0463","Ortun","KYST",4,1,5
"1201","Bergen","0463","Ortun","MDG",31,16,47
"1201","Bergen","0463","Ortun","NKP",1,3,4
"1201","Bergen","0463","Ortun","PP",13,22,35
"1201","Bergen","0463","Ortun","BYLUFT",8,4,12
"1201","Bergen","0464","Varden","A",470,161,631
"1201","Bergen","0464","Varden","SV",42,19,61
"1201","Bergen","0464","Varden","RØDT",33,12,45
"1201","Bergen","0464","Varden","SP",9,3,12
"1201","Bergen","0464","Varden","KRF",63,27,90
"1201","Bergen","0464","Varden","V",90,25,115
"1201","Bergen","0464","Varden","H",696,241,937
"1201","Bergen","0464","Varden","FRP",193,76,269
"1201","Bergen","0464","Varden","DEMN",3,1,4
"1201","Bergen","0464","Varden","KSP",1,1,2
"1201","Bergen","0464","Varden","KYST",4,0,4
"1201","Bergen","0464","Varden","MDG",21,11,32
"1201","Bergen","0464","Varden","PP",6,9,15
"1201","Bergen","0464","Varden","BYLUFT",11,6,17
"1201","Bergen","0567","Olsvik","A",789,373,1162
"1201","Bergen","0567","Olsvik","SV",77,28,105
"1201","Bergen","0567","Olsvik","RØDT",44,30,74
"1201","Bergen","0567","Olsvik","SP",27,13,40
"1201","Bergen","0567","Olsvik","KRF",126,53,179
"1201","Bergen","0567","Olsvik","V",128,33,161
"1201","Bergen","0567","Olsvik","H",942,339,1281
"1201","Bergen","0567","Olsvik","FRP",380,182,562
"1201","Bergen","0567","Olsvik","DEMN",5,2,7
"1201","Bergen","0567","Olsvik","KSP",5,0,5
"1201","Bergen","0567","Olsvik","KYST",5,3,8
"1201","Bergen","0567","Olsvik","MDG",32,13,45
"1201","Bergen","0567","Olsvik","NKP",3,4,7
"1201","Bergen","0567","Olsvik","PP",20,11,31
"1201","Bergen","0567","Olsvik","BYLUFT",7,6,13
"1201","Bergen","0568","Vadmyra","A",635,272,907
"1201","Bergen","0568","Vadmyra","SV",57,25,82
"1201","Bergen","0568","Vadmyra","RØDT",46,28,74
"1201","Bergen","0568","Vadmyra","SP",13,10,23
"1201","Bergen","0568","Vadmyra","KRF",79,39,118
"1201","Bergen","0568","Vadmyra","V",80,31,111
"1201","Bergen","0568","Vadmyra","H",618,212,830
"1201","Bergen","0568","Vadmyra","FRP",318,127,445
"1201","Bergen","0568","Vadmyra","DEMN",7,1,8
"1201","Bergen","0568","Vadmyra","KSP",8,0,8
"1201","Bergen","0568","Vadmyra","KYST",6,1,7
"1201","Bergen","0568","Vadmyra","MDG",22,7,29
"1201","Bergen","0568","Vadmyra","NKP",3,0,3
"1201","Bergen","0568","Vadmyra","PP",13,15,28
"1201","Bergen","0568","Vadmyra","BYLUFT",7,3,10
"1201","Bergen","0569","Mathopen","A",326,53,379
"1201","Bergen","0569","Mathopen","SV",30,7,37
"1201","Bergen","0569","Mathopen","RØDT",19,11,30
"1201","Bergen","0569","Mathopen","SP",5,1,6
"1201","Bergen","0569","Mathopen","KRF",67,18,85
"1201","Bergen","0569","Mathopen","V",46,12,58
"1201","Bergen","0569","Mathopen","H",497,115,612
"1201","Bergen","0569","Mathopen","FRP",146,44,190
"1201","Bergen","0569","Mathopen","DEMN",1,0,1
"1201","Bergen","0569","Mathopen","KSP",1,0,1
"1201","Bergen","0569","Mathopen","KYST",2,1,3
"1201","Bergen","0569","Mathopen","MDG",10,1,11
"1201","Bergen","0569","Mathopen","NKP",1,0,1
"1201","Bergen","0569","Mathopen","PP",9,5,14
"1201","Bergen","0569","Mathopen","BYLUFT",2,1,3
"1201","Bergen","0570","Alvøen","A",517,207,724
"1201","Bergen","0570","Alvøen","SV",37,15,52
"1201","Bergen","0570","Alvøen","RØDT",28,15,43
"1201","Bergen","0570","Alvøen","SP",14,7,21
"1201","Bergen","0570","Alvøen","KRF",78,40,118
"1201","Bergen","0570","Alvøen","V",72,25,97
"1201","Bergen","0570","Alvøen","H",779,246,1025
"1201","Bergen","0570","Alvøen","FRP",199,85,284
"1201","Bergen","0570","Alvøen","DEMN",5,4,9
"1201","Bergen","0570","Alvøen","KSP",1,0,1
"1201","Bergen","0570","Alvøen","KYST",1,0,1
"1201","Bergen","0570","Alvøen","MDG",12,7,19
"1201","Bergen","0570","Alvøen","NKP",2,0,2
"1201","Bergen","0570","Alvøen","PP",7,6,13
"1201","Bergen","0570","Alvøen","BYLUFT",7,1,8
"1201","Bergen","0571","Bjørndalsskogen","A",277,119,396
"1201","Bergen","0571","Bjørndalsskogen","SV",21,13,34
"1201","Bergen","0571","Bjørndalsskogen","RØDT",8,6,14
"1201","Bergen","0571","Bjørndalsskogen","SP",8,5,13
"1201","Bergen","0571","Bjørndalsskogen","KRF",39,13,52
"1201","Bergen","0571","Bjørndalsskogen","V",37,5,42
"1201","Bergen","0571","Bjørndalsskogen","H",299,97,396
"1201","Bergen","0571","Bjørndalsskogen","FRP",108,40,148
"1201","Bergen","0571","Bjørndalsskogen","DEMN",1,1,2
"1201","Bergen","0571","Bjørndalsskogen","KSP",5,4,9
"1201","Bergen","0571","Bjørndalsskogen","KYST",1,1,2
"1201","Bergen","0571","Bjørndalsskogen","MDG",7,4,11
"1201","Bergen","0571","Bjørndalsskogen","NKP",1,0,1
"1201","Bergen","0571","Bjørndalsskogen","PP",1,3,4
"1201","Bergen","0571","Bjørndalsskogen","BYLUFT",2,0,2
"1201","Bergen","0574","Damsgård","A",727,264,991
"1201","Bergen","0574","Damsgård","SV",127,38,165
"1201","Bergen","0574","Damsgård","RØDT",89,33,122
"1201","Bergen","0574","Damsgård","SP",43,4,47
"1201","Bergen","0574","Damsgård","KRF",90,33,123
"1201","Bergen","0574","Damsgård","V",176,55,231
"1201","Bergen","0574","Damsgård","H",675,207,882
"1201","Bergen","0574","Damsgård","FRP",280,103,383
"1201","Bergen","0574","Damsgård","DEMN",6,2,8
"1201","Bergen","0574","Damsgård","KSP",7,1,8
"1201","Bergen","0574","Damsgård","KYST",3,2,5
"1201","Bergen","0574","Damsgård","MDG",39,22,61
"1201","Bergen","0574","Damsgård","NKP",1,4,5
"1201","Bergen","0574","Damsgård","PP",17,12,29
"1201","Bergen","0574","Damsgård","BYLUFT",27,9,36
"1201","Bergen","0575","Holen","A",152,36,188
"1201","Bergen","0575","Holen","SV",25,6,31
"1201","Bergen","0575","Holen","RØDT",21,4,25
"1201","Bergen","0575","Holen","SP",7,2,9
"1201","Bergen","0575","Holen","KRF",20,4,24
"1201","Bergen","0575","Holen","V",37,7,44
"1201","Bergen","0575","Holen","H",132,44,176
"1201","Bergen","0575","Holen","FRP",66,15,81
"1201","Bergen","0575","Holen","DEMN",2,1,3
"1201","Bergen","0575","Holen","KSP",1,0,1
"1201","Bergen","0575","Holen","KYST",1,0,1
"1201","Bergen","0575","Holen","MDG",9,6,15
"1201","Bergen","0575","Holen","PP",2,2,4
"1201","Bergen","0575","Holen","BYLUFT",7,1,8
"1201","Bergen","0576","Nygårdslien","A",512,225,737
"1201","Bergen","0576","Nygårdslien","SV",54,19,73
"1201","Bergen","0576","Nygårdslien","RØDT",44,10,54
"1201","Bergen","0576","Nygårdslien","SP",21,14,35
"1201","Bergen","0576","Nygårdslien","KRF",69,23,92
"1201","Bergen","0576","Nygårdslien","V",99,22,121
"1201","Bergen","0576","Nygårdslien","H",607,230,837
"1201","Bergen","0576","Nygårdslien","FRP",210,102,312
"1201","Bergen","0576","Nygårdslien","DEMN",4,1,5
"1201","Bergen","0576","Nygårdslien","KSP",6,2,8
"1201","Bergen","0576","Nygårdslien","KYST",4,0,4
"1201","Bergen","0576","Nygårdslien","MDG",20,2,22
"1201","Bergen","0576","Nygårdslien","NKP",1,2,3
"1201","Bergen","0576","Nygårdslien","PP",13,3,16
"1201","Bergen","0576","Nygårdslien","BYLUFT",19,3,22
"1201","Bergen","0654","Sandsli","A",456,243,699
"1201","Bergen","0654","Sandsli","SV",56,45,101
"1201","Bergen","0654","Sandsli","RØDT",24,12,36
"1201","Bergen","0654","Sandsli","SP",17,8,25
"1201","Bergen","0654","Sandsli","KRF",121,61,182
"1201","Bergen","0654","Sandsli","V",99,29,128
"1201","Bergen","0654","Sandsli","H",728,317,1045
"1201","Bergen","0654","Sandsli","FRP",164,102,266
"1201","Bergen","0654","Sandsli","DEMN",1,0,1
"1201","Bergen","0654","Sandsli","KSP",4,2,6
"1201","Bergen","0654","Sandsli","KYST",1,3,4
"1201","Bergen","0654","Sandsli","MDG",13,8,21
"1201","Bergen","0654","Sandsli","NKP",2,0,2
"1201","Bergen","0654","Sandsli","PP",8,10,18
"1201","Bergen","0654","Sandsli","BYLUFT",7,1,8
"1201","Bergen","0655","Rå","A",588,304,892
"1201","Bergen","0655","Rå","SV",50,43,93
"1201","Bergen","0655","Rå","RØDT",32,22,54
"1201","Bergen","0655","Rå","SP",23,17,40
"1201","Bergen","0655","Rå","KRF",101,73,174
"1201","Bergen","0655","Rå","V",170,74,244
"1201","Bergen","0655","Rå","H",967,488,1455
"1201","Bergen","0655","Rå","FRP",165,121,286
"1201","Bergen","0655","Rå","DEMN",2,2,4
"1201","Bergen","0655","Rå","KSP",7,1,8
"1201","Bergen","0655","Rå","KYST",3,1,4
"1201","Bergen","0655","Rå","MDG",30,15,45
"1201","Bergen","0655","Rå","NKP",1,0,1
"1201","Bergen","0655","Rå","PP",5,13,18
"1201","Bergen","0655","Rå","BYLUFT",6,4,10
"1201","Bergen","0656","Hjellestad","A",199,54,253
"1201","Bergen","0656","Hjellestad","SV",22,9,31
"1201","Bergen","0656","Hjellestad","RØDT",11,4,15
"1201","Bergen","0656","Hjellestad","SP",11,11,22
"1201","Bergen","0656","Hjellestad","KRF",33,9,42
"1201","Bergen","0656","Hjellestad","V",44,11,55
"1201","Bergen","0656","Hjellestad","H",523,112,635
"1201","Bergen","0656","Hjellestad","FRP",123,41,164
"1201","Bergen","0656","Hjellestad","DEMN",1,0,1
"1201","Bergen","0656","Hjellestad","KSP",2,0,2
"1201","Bergen","0656","Hjellestad","KYST",2,0,2
"1201","Bergen","0656","Hjellestad","MDG",6,3,9
"1201","Bergen","0656","Hjellestad","PP",2,0,2
"1201","Bergen","0656","Hjellestad","BYLUFT",3,2,5
"1201","Bergen","0657","Skeie","A",190,55,245
"1201","Bergen","0657","Skeie","SV",18,7,25
"1201","Bergen","0657","Skeie","RØDT",12,2,14
"1201","Bergen","0657","Skeie","SP",21,8,29
"1201","Bergen","0657","Skeie","KRF",25,9,34
"1201","Bergen","0657","Skeie","V",44,8,52
"1201","Bergen","0657","Skeie","H",406,125,531
"1201","Bergen","0657","Skeie","FRP",80,23,103
"1201","Bergen","0657","Skeie","DEMN",1,0,1
"1201","Bergen","0657","Skeie","KSP",3,0,3
"1201","Bergen","0657","Skeie","KYST",1,1,2
"1201","Bergen","0657","Skeie","MDG",7,1,8
"1201","Bergen","0657","Skeie","PP",2,1,3
"1201","Bergen","0657","Skeie","BYLUFT",4,0,4
"1201","Bergen","0658","Liland","A",299,68,367
"1201","Bergen","0658","Liland","SV",20,3,23
"1201","Bergen","0658","Liland","RØDT",17,4,21
"1201","Bergen","0658","Liland","SP",21,5,26
"1201","Bergen","0658","Liland","KRF",119,34,153
"1201","Bergen","0658","Liland","V",58,10,68
"1201","Bergen","0658","Liland","H",476,95,571
"1201","Bergen","0658","Liland","FRP",189,36,225
"1201","Bergen","0658","Liland","DEMN",3,0,3
"1201","Bergen","0658","Liland","KSP",2,1,3
"1201","Bergen","0658","Liland","MDG",11,3,14
"1201","Bergen","0658","Liland","NKP",1,0,1
"1201","Bergen","0658","Liland","PP",5,2,7
"1201","Bergen","0658","Liland","BYLUFT",9,0,9
"1201","Bergen","0659","Søreide","A",469,191,660
"1201","Bergen","0659","Søreide","SV",40,15,55
"1201","Bergen","0659","Søreide","RØDT",40,13,53
"1201","Bergen","0659","Søreide","SP",18,9,27
"1201","Bergen","0659","Søreide","KRF",108,44,152
"1201","Bergen","0659","Søreide","V",118,37,155
"1201","Bergen","0659","Søreide","H",1025,300,1325
"1201","Bergen","0659","Søreide","FRP",233,77,310
"1201","Bergen","0659","Søreide","DEMN",3,2,5
"1201","Bergen","0659","Søreide","KSP",4,3,7
"1201","Bergen","0659","Søreide","MDG",19,13,32
"1201","Bergen","0659","Søreide","NKP",1,0,1
"1201","Bergen","0659","Søreide","PP",9,11,20
"1201","Bergen","0659","Søreide","BYLUFT",8,2,10
"1201","Bergen","0707","Ny Krohnborg","A",617,320,937
"1201","Bergen","0707","Ny Krohnborg","SV",141,84,225
"1201","Bergen","0707","Ny Krohnborg","RØDT",104,35,139
"1201","Bergen","0707","Ny Krohnborg","SP",35,10,45
"1201","Bergen","0707","Ny Krohnborg","KRF",129,69,198
"1201","Bergen","0707","Ny Krohnborg","V",233,92,325
"1201","Bergen","0707","Ny Krohnborg","H",468,188,656
"1201","Bergen","0707","Ny Krohnborg","FRP",178,89,267
"1201","Bergen","0707","Ny Krohnborg","DEMN",10,3,13
"1201","Bergen","0707","Ny Krohnborg","KSP",6,4,10
"1201","Bergen","0707","Ny Krohnborg","KYST",3,1,4
"1201","Bergen","0707","Ny Krohnborg","MDG",78,27,105
"1201","Bergen","0707","Ny Krohnborg","NKP",6,2,8
"1201","Bergen","0707","Ny Krohnborg","PP",4,3,7
"1201","Bergen","0707","Ny Krohnborg","BYLUFT",74,22,96
"1201","Bergen","0710","Minde","A",296,64,360
"1201","Bergen","0710","Minde","SV",68,16,84
"1201","Bergen","0710","Minde","RØDT",55,12,67
"1201","Bergen","0710","Minde","SP",9,3,12
"1201","Bergen","0710","Minde","KRF",64,17,81
"1201","Bergen","0710","Minde","V",105,19,124
"1201","Bergen","0710","Minde","H",330,94,424
"1201","Bergen","0710","Minde","FRP",111,25,136
"1201","Bergen","0710","Minde","DEMN",3,1,4
"1201","Bergen","0710","Minde","KSP",1,1,2
"1201","Bergen","0710","Minde","KYST",0,1,1
"1201","Bergen","0710","Minde","MDG",26,11,37
"1201","Bergen","0710","Minde","NKP",1,0,1
"1201","Bergen","0710","Minde","PP",4,0,4
"1201","Bergen","0710","Minde","BYLUFT",12,10,22
"1201","Bergen","0713","Landås","A",920,481,1401
"1201","Bergen","0713","Landås","SV",181,88,269
"1201","Bergen","0713","Landås","RØDT",150,49,199
"1201","Bergen","0713","Landås","SP",43,9,52
"1201","Bergen","0713","Landås","KRF",207,100,307
"1201","Bergen","0713","Landås","V",310,109,419
"1201","Bergen","0713","Landås","H",1041,470,1511
"1201","Bergen","0713","Landås","FRP",236,134,370
"1201","Bergen","0713","Landås","DEMN",4,2,6
"1201","Bergen","0713","Landås","KSP",2,2,4
"1201","Bergen","0713","Landås","KYST",3,1,4
"1201","Bergen","0713","Landås","MDG",80,29,109
"1201","Bergen","0713","Landås","NKP",5,2,7
"1201","Bergen","0713","Landås","PP",17,10,27
"1201","Bergen","0713","Landås","BYLUFT",57,24,81
"1201","Bergen","0714","Slettebakken","A",769,320,1089
"1201","Bergen","0714","Slettebakken","SV",165,51,216
"1201","Bergen","0714","Slettebakken","RØDT",109,42,151
"1201","Bergen","0714","Slettebakken","SP",35,12,47
"1201","Bergen","0714","Slettebakken","KRF",222,90,312
"1201","Bergen","0714","Slettebakken","V",205,81,286
"1201","Bergen","0714","Slettebakken","H",669,250,919
"1201","Bergen","0714","Slettebakken","FRP",199,69,268
"1201","Bergen","0714","Slettebakken","DEMN",5,5,10
"1201","Bergen","0714","Slettebakken","KSP",7,1,8
"1201","Bergen","0714","Slettebakken","KYST",3,0,3
"1201","Bergen","0714","Slettebakken","MDG",74,26,100
"1201","Bergen","0714","Slettebakken","NKP",0,2,2
"1201","Bergen","0714","Slettebakken","PP",9,9,18
"1201","Bergen","0714","Slettebakken","BYLUFT",45,15,60
"1201","Bergen","0715","Gimle","A",939,383,1322
"1201","Bergen","0715","Gimle","SV",200,93,293
"1201","Bergen","0715","Gimle","RØDT",155,55,210
"1201","Bergen","0715","Gimle","SP",33,14,47
"1201","Bergen","0715","Gimle","KRF",209,78,287
"1201","Bergen","0715","Gimle","V",334,130,464
"1201","Bergen","0715","Gimle","H",856,291,1147
"1201","Bergen","0715","Gimle","FRP",210,93,303
"1201","Bergen","0715","Gimle","DEMN",9,1,10
"1201","Bergen","0715","Gimle","KSP",3,1,4
"1201","Bergen","0715","Gimle","KYST",2,0,2
"1201","Bergen","0715","Gimle","MDG",111,48,159
"1201","Bergen","0715","Gimle","NKP",2,3,5
"1201","Bergen","0715","Gimle","PP",15,6,21
"1201","Bergen","0715","Gimle","BYLUFT",97,41,138
"1201","Bergen","0822","Eidsvåg","A",469,183,652
"1201","Bergen","0822","Eidsvåg","SV",61,21,82
"1201","Bergen","0822","Eidsvåg","RØDT",50,29,79
"1201","Bergen","0822","Eidsvåg","SP",13,5,18
"1201","Bergen","0822","Eidsvåg","KRF",76,28,104
"1201","Bergen","0822","Eidsvåg","V",133,40,173
"1201","Bergen","0822","Eidsvåg","H",733,253,986
"1201","Bergen","0822","Eidsvåg","FRP",168,86,254
"1201","Bergen","0822","Eidsvåg","DEMN",2,0,2
"1201","Bergen","0822","Eidsvåg","KSP",0,2,2
"1201","Bergen","0822","Eidsvåg","KYST",1,1,2
"1201","Bergen","0822","Eidsvåg","MDG",23,7,30
"1201","Bergen","0822","Eidsvåg","NKP",1,0,1
"1201","Bergen","0822","Eidsvåg","PP",2,7,9
"1201","Bergen","0822","Eidsvåg","BYLUFT",4,3,7
"1201","Bergen","0823","Tertnes","A",642,273,915
"1201","Bergen","0823","Tertnes","SV",79,34,113
"1201","Bergen","0823","Tertnes","RØDT",50,25,75
"1201","Bergen","0823","Tertnes","SP",36,13,49
"1201","Bergen","0823","Tertnes","KRF",127,51,178
"1201","Bergen","0823","Tertnes","V",117,50,167
"1201","Bergen","0823","Tertnes","H",1054,356,1410
"1201","Bergen","0823","Tertnes","FRP",253,139,392
"1201","Bergen","0823","Tertnes","DEMN",2,2,4
"1201","Bergen","0823","Tertnes","KSP",7,1,8
"1201","Bergen","0823","Tertnes","KYST",2,0,2
"1201","Bergen","0823","Tertnes","MDG",27,6,33
"1201","Bergen","0823","Tertnes","NKP",1,0,1
"1201","Bergen","0823","Tertnes","PP",7,6,13
"1201","Bergen","0823","Tertnes","BYLUFT",9,2,11
"1201","Bergen","0824","Mjølkeråen","A",365,131,496
"1201","Bergen","0824","Mjølkeråen","SV",42,13,55
"1201","Bergen","0824","Mjølkeråen","RØDT",29,13,42
"1201","Bergen","0824","Mjølkeråen","SP",37,10,47
"1201","Bergen","0824","Mjølkeråen","KRF",106,40,146
"1201","Bergen","0824","Mjølkeråen","V",76,16,92
"1201","Bergen","0824","Mjølkeråen","H",504,121,625
"1201","Bergen","0824","Mjølkeråen","FRP",167,49,216
"1201","Bergen","0824","Mjølkeråen","DEMN",2,1,3
"1201","Bergen","0824","Mjølkeråen","KSP",4,1,5
"1201","Bergen","0824","Mjølkeråen","MDG",19,1,20
"1201","Bergen","0824","Mjølkeråen","NKP",2,0,2
"1201","Bergen","0824","Mjølkeråen","PP",7,2,9
"1201","Bergen","0824","Mjølkeråen","BYLUFT",7,1,8
"1201","Bergen","0825","Salhus","A",130,23,153
"1201","Bergen","0825","Salhus","SV",11,3,14
"1201","Bergen","0825","Salhus","RØDT",3,1,4
"1201","Bergen","0825","Salhus","SP",7,3,10
"1201","Bergen","0825","Salhus","KRF",19,4,23
"1201","Bergen","0825","Salhus","V",24,2,26
"1201","Bergen","0825","Salhus","H",85,11,96
"1201","Bergen","0825","Salhus","FRP",40,8,48
"1201","Bergen","0825","Salhus","MDG",5,1,6
"1201","Bergen","0825","Salhus","PP",1,1,2
"1201","Bergen","0828","Haukedalen","A",725,365,1090
"1201","Bergen","0828","Haukedalen","SV",72,35,107
"1201","Bergen","0828","Haukedalen","RØDT",60,14,74
"1201","Bergen","0828","Haukedalen","SP",34,16,50
"1201","Bergen","0828","Haukedalen","KRF",123,76,199
"1201","Bergen","0828","Haukedalen","V",109,39,148
"1201","Bergen","0828","Haukedalen","H",872,300,1172
"1201","Bergen","0828","Haukedalen","FRP",267,139,406
"1201","Bergen","0828","Haukedalen","DEMN",2,2,4
"1201","Bergen","0828","Haukedalen","KSP",5,4,9
"1201","Bergen","0828","Haukedalen","KYST",4,0,4
"1201","Bergen","0828","Haukedalen","MDG",19,6,25
"1201","Bergen","0828","Haukedalen","NKP",3,1,4
"1201","Bergen","0828","Haukedalen","PP",12,18,30
"1201","Bergen","0828","Haukedalen","BYLUFT",7,3,10
"1201","Bergen","0829","Hordvik","A",227,64,291
"1201","Bergen","0829","Hordvik","SV",22,9,31
"1201","Bergen","0829","Hordvik","RØDT",10,4,14
"1201","Bergen","0829","Hordvik","SP",20,4,24
"1201","Bergen","0829","Hordvik","KRF",76,10,86
"1201","Bergen","0829","Hordvik","V",44,8,52
"1201","Bergen","0829","Hordvik","H",345,63,408
"1201","Bergen","0829","Hordvik","FRP",120,30,150
"1201","Bergen","0829","Hordvik","DEMN",4,0,4
"1201","Bergen","0829","Hordvik","KSP",4,0,4
"1201","Bergen","0829","Hordvik","MDG",14,0,14
"1201","Bergen","0829","Hordvik","NKP",2,1,3
"1201","Bergen","0829","Hordvik","PP",7,1,8
"1201","Bergen","0829","Hordvik","BYLUFT",2,0,2
"1201","Bergen","0830","Haukås","A",231,36,267
"1201","Bergen","0830","Haukås","SV",34,8,42
"1201","Bergen","0830","Haukås","RØDT",18,2,20
"1201","Bergen","0830","Haukås","SP",20,0,20
"1201","Bergen","0830","Haukås","KRF",54,13,67
"1201","Bergen","0830","Haukås","V",27,6,33
"1201","Bergen","0830","Haukås","H",301,60,361
"1201","Bergen","0830","Haukås","FRP",152,32,184
"1201","Bergen","0830","Haukås","DEMN",2,0,2
"1201","Bergen","0830","Haukås","KSP",3,0,3
"1201","Bergen","0830","Haukås","KYST",1,0,1
"1201","Bergen","0830","Haukås","MDG",6,4,10
"1201","Bergen","0830","Haukås","PP",4,0,4
"1201","Bergen","0831","Nyborg","A",1143,365,1508
"1201","Bergen","0831","Nyborg","SV",89,51,140
"1201","Bergen","0831","Nyborg","RØDT",88,29,117
"1201","Bergen","0831","Nyborg","SP",79,22,101
"1201","Bergen","0831","Nyborg","KRF",209,75,284
"1201","Bergen","0831","Nyborg","V",110,50,160
"1201","Bergen","0831","Nyborg","H",978,281,1259
"1201","Bergen","0831","Nyborg","FRP",388,140,528
"1201","Bergen","0831","Nyborg","DEMN",10,4,14
"1201","Bergen","0831","Nyborg","KSP",16,6,22
"1201","Bergen","0831","Nyborg","KYST",8,0,8
"1201","Bergen","0831","Nyborg","MDG",29,6,35
"1201","Bergen","0831","Nyborg","NKP",2,2,4
"1201","Bergen","0831","Nyborg","PP",17,7,24
"1201","Bergen","0831","Nyborg","BYLUFT",2,3,5
"1201","Bergen","0832","Rolland","A",504,142,646
"1201","Bergen","0832","Rolland","SV",61,9,70
"1201","Bergen","0832","Rolland","RØDT",38,21,59
"1201","Bergen","0832","Rolland","SP",21,8,29
"1201","Bergen","0832","Rolland","KRF",67,27,94
"1201","Bergen","0832","Rolland","V",53,30,83
"1201","Bergen","0832","Rolland","H",444,118,562
"1201","Bergen","0832","Rolland","FRP",180,55,235
"1201","Bergen","0832","Rolland","DEMN",2,3,5
"1201","Bergen","0832","Rolland","KSP",3,1,4
"1201","Bergen","0832","Rolland","KYST",3,0,3
"1201","Bergen","0832","Rolland","MDG",15,8,23
"1201","Bergen","0832","Rolland","NKP",1,0,1
"1201","Bergen","0832","Rolland","PP",4,5,9
"1201","Bergen","0832","Rolland","BYLUFT",2,2,4
"1211","Etne","0000",,"A",440,123,563
"1211","Etne","0000",,"SP",499,97,596
"1211","Etne","0000",,"KRF",133,40,173
"1211","Etne","0000",,"V",57,31,88
"1211","Etne","0000",,"H",230,74,304
"1211","Etne","0000",,"FRP",205,58,263
"1216","Sveio","0000",,"A",424,110,534
"1216","Sveio","0000",,"SP",261,50,311
"1216","Sveio","0000",,"KRF",254,78,332
"1216","Sveio","0000",,"V",113,24,137
"1216","Sveio","0000",,"H",499,100,599
"1216","Sveio","0000",,"FRP",421,100,521
"1216","Sveio","0000",,"KYST",41,7,48
"1216","Sveio","0000",,"FMD_SV",95,21,116
"1219","Bømlo","0000",,"A",1005,321,1326
"1219","Bømlo","0000",,"SP",208,51,259
"1219","Bømlo","0000",,"KRF",692,216,908
"1219","Bømlo","0000",,"V",258,84,342
"1219","Bømlo","0000",,"H",1066,382,1448
"1219","Bømlo","0000",,"FRP",669,213,882
"1219","Bømlo","0000",,"KRISTNE",279,81,360
"1221","Stord","0000",,"A",1720,583,2303
"1221","Stord","0000",,"SV",368,132,500
"1221","Stord","0000",,"RØDT",100,17,117
"1221","Stord","0000",,"SP",523,107,630
"1221","Stord","0000",,"KRF",584,202,786
"1221","Stord","0000",,"V",362,98,460
"1221","Stord","0000",,"H",1721,533,2254
"1221","Stord","0000",,"FRP",965,333,1298
"1221","Stord","0000",,"DEMN",172,53,225
"1222","Fitjar","0000",,"A",198,37,235
"1222","Fitjar","0000",,"SP",141,17,158
"1222","Fitjar","0000",,"KRF",332,62,394
"1222","Fitjar","0000",,"H",560,72,632
"1222","Fitjar","0000",,"FRP",77,24,101
"1222","Fitjar","0000",,"FLISTO",29,8,37
"1223","Tysnes","0000",,"A",379,128,507
"1223","Tysnes","0000",,"SP",125,38,163
"1223","Tysnes","0000",,"KRF",169,59,228
"1223","Tysnes","0000",,"V",87,34,121
"1223","Tysnes","0000",,"H",210,67,277
"1223","Tysnes","0000",,"FRP",206,63,269
"1224","Kvinnherad","0000",,"A",1324,350,1674
"1224","Kvinnherad","0000",,"SV",93,39,132
"1224","Kvinnherad","0000",,"RØDT",80,31,111
"1224","Kvinnherad","0000",,"SP",425,69,494
"1224","Kvinnherad","0000",,"KRF",427,127,554
"1224","Kvinnherad","0000",,"V",291,76,367
"1224","Kvinnherad","0000",,"H",1777,300,2077
"1224","Kvinnherad","0000",,"FRP",726,180,906
"1224","Kvinnherad","0000",,"INNB",151,38,189
"1227","Jondal","0000",,"A",105,33,138
"1227","Jondal","0000",,"SP",228,82,310
"1227","Jondal","0000",,"KRF",54,29,83
"1227","Jondal","0000",,"H",52,22,74
"1228","Odda","0000",,"A",794,421,1215
"1228","Odda","0000",,"RØDT",277,145,422
"1228","Odda","0000",,"SP",156,64,220
"1228","Odda","0000",,"V",256,118,374
"1228","Odda","0000",,"H",445,180,625
"1228","Odda","0000",,"DEMN",143,88,231
"1228","Odda","0000",,"NYODDA",413,176,589
"1231","Ullensvang Herad","0000",,"A",143,40,183
"1231","Ullensvang Herad","0000",,"SV",88,34,122
"1231","Ullensvang Herad","0000",,"RØDT",11,3,14
"1231","Ullensvang Herad","0000",,"SP",554,120,674
"1231","Ullensvang Herad","0000",,"KRF",84,17,101
"1231","Ullensvang Herad","0000",,"V",337,75,412
"1231","Ullensvang Herad","0000",,"H",303,68,371
"1232","Eidfjord","0000",,"A",117,42,159
"1232","Eidfjord","0000",,"SP",165,67,232
"1232","Eidfjord","0000",,"V",25,3,28
"1232","Eidfjord","0000",,"H",67,21,88
"1232","Eidfjord","0000",,"TVB",28,7,35
"1233","Ulvik","0000",,"A",86,41,127
"1233","Ulvik","0000",,"SV",42,22,64
"1233","Ulvik","0000",,"SP",93,29,122
"1233","Ulvik","0000",,"V",149,63,212
"1233","Ulvik","0000",,"H",77,34,111
"1234","Granvin","0000",,"SV",36,14,50
"1234","Granvin","0000",,"SP",123,26,149
"1234","Granvin","0000",,"V",121,45,166
"1234","Granvin","0000",,"H",80,30,110
"1235","Voss","0000",,"A",1623,433,2056
"1235","Voss","0000",,"SV",355,120,475
"1235","Voss","0000",,"RØDT",139,53,192
"1235","Voss","0000",,"SP",1033,232,1265
"1235","Voss","0000",,"KRF",249,103,352
"1235","Voss","0000",,"V",600,189,789
"1235","Voss","0000",,"H",1057,294,1351
"1235","Voss","0000",,"FRP",487,153,640
"1235","Voss","0000",,"MDG",57,18,75
"1238","Kvam","0000",,"A",430,204,634
"1238","Kvam","0000",,"SV",83,36,119
"1238","Kvam","0000",,"RØDT",58,26,84
"1238","Kvam","0000",,"SP",779,189,968
"1238","Kvam","0000",,"KRF",445,169,614
"1238","Kvam","0000",,"V",253,94,347
"1238","Kvam","0000",,"H",557,178,735
"1238","Kvam","0000",,"FRP",278,141,419
"1238","Kvam","0000",,"BYG_NOR",47,17,64
"1238","Kvam","0000",,"KTL",404,104,508
"1241","Fusa","0000",,"A",264,67,331
"1241","Fusa","0000",,"SV",52,22,74
"1241","Fusa","0000",,"SP",463,91,554
"1241","Fusa","0000",,"KRF",195,61,256
"1241","Fusa","0000",,"V",63,22,85
"1241","Fusa","0000",,"H",216,55,271
"1241","Fusa","0000",,"FRP",371,79,450
"1242","Samnanger","0000",,"A",282,53,335
"1242","Samnanger","0000",,"SP",113,18,131
"1242","Samnanger","0000",,"KRF",218,33,251
"1242","Samnanger","0000",,"H",127,20,147
"1242","Samnanger","0000",,"FRP",198,38,236
"1242","Samnanger","0000",,"BYGS",153,22,175
"1243","Os","0000",,"A",1291,411,1702
"1243","Os","0000",,"SV",113,43,156
"1243","Os","0000",,"RØDT",23,7,30
"1243","Os","0000",,"SP",231,61,292
"1243","Os","0000",,"KRF",324,143,467
"1243","Os","0000",,"V",341,128,469
"1243","Os","0000",,"H",1105,301,1406
"1243","Os","0000",,"FRP",2450,860,3310
"1243","Os","0000",,"MDG",66,23,89
"1243","Os","0000",,"TSBO",693,170,863
"1244","Austevoll","0000",,"A",145,46,191
"1244","Austevoll","0000",,"SP",145,30,175
"1244","Austevoll","0000",,"KRF",108,38,146
"1244","Austevoll","0000",,"V",29,14,43
"1244","Austevoll","0000",,"H",582,213,795
"1244","Austevoll","0000",,"FRP",880,337,1217
"1245","Sund","0000",,"A",478,122,600
"1245","Sund","0000",,"SV",67,14,81
"1245","Sund","0000",,"SP",195,26,221
"1245","Sund","0000",,"KRF",106,33,139
"1245","Sund","0000",,"V",123,20,143
"1245","Sund","0000",,"H",1095,215,1310
"1245","Sund","0000",,"FRP",404,83,487
"1246","Fjell","0000",,"A",1803,471,2274
"1246","Fjell","0000",,"SV",139,35,174
"1246","Fjell","0000",,"RØDT",62,17,79
"1246","Fjell","0000",,"SP",204,54,258
"1246","Fjell","0000",,"KRF",734,266,1000
"1246","Fjell","0000",,"V",389,101,490
"1246","Fjell","0000",,"H",2382,529,2911
"1246","Fjell","0000",,"FRP",1389,439,1828
"1246","Fjell","0000",,"KYST",57,14,71
"1246","Fjell","0000",,"SOT",1151,142,1293
"1247","Askøy","0000",,"A",2901,821,3722
"1247","Askøy","0000",,"SV",284,104,388
"1247","Askøy","0000",,"RØDT",174,34,208
"1247","Askøy","0000",,"KRF",584,176,760
"1247","Askøy","0000",,"V",517,129,646
"1247","Askøy","0000",,"H",3355,654,4009
"1247","Askøy","0000",,"FRP",1574,446,2020
"1247","Askøy","0000",,"DEMN",389,133,522
"1247","Askøy","0000",,"MDG",114,28,142
"1251","Vaksdal","0000",,"A",746,194,940
"1251","Vaksdal","0000",,"SV",126,21,147
"1251","Vaksdal","0000",,"RØDT",9,8,17
"1251","Vaksdal","0000",,"SP",224,44,268
"1251","Vaksdal","0000",,"KRF",169,45,214
"1251","Vaksdal","0000",,"V",42,8,50
"1251","Vaksdal","0000",,"H",272,76,348
"1251","Vaksdal","0000",,"FRP",113,33,146
"1252","Modalen","0000",,"SLMO",87,36,123
"1252","Modalen","0000",,"SOLR",85,14,99
"1253","Osterøy","0000",,"A",1128,244,1372
"1253","Osterøy","0000",,"RØDT",62,24,86
"1253","Osterøy","0000",,"SP",342,41,383
"1253","Osterøy","0000",,"KRF",297,63,360
"1253","Osterøy","0000",,"V",171,43,214
"1253","Osterøy","0000",,"H",749,112,861
"1253","Osterøy","0000",,"FRP",555,120,675
"1256","Meland","0000",,"A",487,123,610
"1256","Meland","0000",,"SP",455,107,562
"1256","Meland","0000",,"KRF",279,94,373
"1256","Meland","0000",,"V",198,27,225
"1256","Meland","0000",,"H",682,140,822
"1256","Meland","0000",,"FRP",404,73,477
"1256","Meland","0000",,"MDG",96,15,111
"1256","Meland","0000",,"RV_SV_SD",161,52,213
"1259","Øygarden","0000",,"A",529,183,712
"1259","Øygarden","0000",,"SV",83,23,106
"1259","Øygarden","0000",,"KRF",98,41,139
"1259","Øygarden","0000",,"H",286,94,380
"1259","Øygarden","0000",,"FRP",125,96,221
"1259","Øygarden","0000",,"TVØ",525,249,774
"1260","Radøy","0000",,"A",238,160,398
"1260","Radøy","0000",,"RØDT",32,14,46
"1260","Radøy","0000",,"SP",586,314,900
"1260","Radøy","0000",,"KRF",132,75,207
"1260","Radøy","0000",,"V",90,70,160
"1260","Radøy","0000",,"H",293,202,495
"1260","Radøy","0000",,"FRP",132,112,244
"1263","Lindås","0000",,"A",1050,303,1353
"1263","Lindås","0000",,"SV",104,31,135
"1263","Lindås","0000",,"RØDT",43,21,64
"1263","Lindås","0000",,"SP",563,123,686
"1263","Lindås","0000",,"KRF",1570,327,1897
"1263","Lindås","0000",,"V",278,57,335
"1263","Lindås","0000",,"H",1341,250,1591
"1263","Lindås","0000",,"FRP",868,201,1069
"1263","Lindås","0000",,"MDG",50,14,64
"1264","Austrheim","0000",,"A",406,131,537
"1264","Austrheim","0000",,"SP",46,12,58
"1264","Austrheim","0000",,"KRF",120,47,167
"1264","Austrheim","0000",,"V",146,26,172
"1264","Austrheim","0000",,"H",283,109,392
"1264","Austrheim","0000",,"FRP",64,24,88
"1265","Fedje","0000",,"A",93,43,136
"1265","Fedje","0000",,"KRF",47,30,77
"1265","Fedje","0000",,"H",67,45,112
"1265","Fedje","0000",,"FRP",36,14,50
"1265","Fedje","0000",,"DEMN",12,6,18
"1266","Masfjorden","0000",,"A",155,39,194
"1266","Masfjorden","0000",,"SP",115,23,138
"1266","Masfjorden","0000",,"KRF",115,22,137
"1266","Masfjorden","0000",,"V",62,24,86
"1266","Masfjorden","0000",,"H",272,48,320
"1266","Masfjorden","0000",,"FRP",94,36,130
"1401","Flora","0000",,"A",1456,341,1797
"1401","Flora","0000",,"SV",167,48,215
"1401","Flora","0000",,"SP",126,20,146
"1401","Flora","0000",,"KRF",172,54,226
"1401","Flora","0000",,"V",665,139,804
"1401","Flora","0000",,"H",1571,383,1954
"1401","Flora","0000",,"FRP",206,76,282
"1401","Flora","0000",,"FDS",52,20,72
"1411","Gulen","0000",,"A",93,40,133
"1411","Gulen","0000",,"SP",422,128,550
"1411","Gulen","0000",,"KRF",74,48,122
"1411","Gulen","0000",,"V",118,59,177
"1411","Gulen","0000",,"H",245,58,303
"1411","Gulen","0000",,"FRP",27,19,46
"1412","Solund","0000",,"A",24,28,52
"1412","Solund","0000",,"SV",9,7,16
"1412","Solund","0000",,"SP",71,64,135
"1412","Solund","0000",,"H",119,41,160
"1412","Solund","0000",,"FRP",26,37,63
"1412","Solund","0000",,"PULS",36,13,49
"1413","Hyllestad","0000",,"A",163,60,223
"1413","Hyllestad","0000",,"SP",180,29,209
"1413","Hyllestad","0000",,"H",81,24,105
"1413","Hyllestad","0000",,"SLHY",129,32,161
"1416","Høyanger","0000",,"A",835,161,996
"1416","Høyanger","0000",,"SV",50,16,66
"1416","Høyanger","0000",,"RØDT",140,31,171
"1416","Høyanger","0000",,"SP",342,63,405
"1416","Høyanger","0000",,"KRF",51,18,69
"1416","Høyanger","0000",,"V",41,6,47
"1416","Høyanger","0000",,"H",314,44,358
"1416","Høyanger","0000",,"KYST",14,3,17
"1417","Vik","0000",,"A",417,96,513
"1417","Vik","0000",,"SV",39,15,54
"1417","Vik","0000",,"SP",263,49,312
"1417","Vik","0000",,"KRF",46,17,63
"1417","Vik","0000",,"V",289,29,318
"1417","Vik","0000",,"H",116,37,153
"1418","Balestrand","0000",,"A",115,61,176
"1418","Balestrand","0000",,"SV",28,12,40
"1418","Balestrand","0000",,"SP",106,25,131
"1418","Balestrand","0000",,"KRF",68,36,104
"1418","Balestrand","0000",,"V",69,21,90
"1418","Balestrand","0000",,"H",128,68,196
"1419","Leikanger","0000",,"A",404,93,497
"1419","Leikanger","0000",,"SV",79,45,124
"1419","Leikanger","0000",,"SP",215,44,259
"1419","Leikanger","0000",,"V",167,64,231
"1419","Leikanger","0000",,"H",114,32,146
"1420","Sogndal","0000",,"A",1020,281,1301
"1420","Sogndal","0000",,"SV",176,79,255
"1420","Sogndal","0000",,"SP",480,138,618
"1420","Sogndal","0000",,"KRF",192,51,243
"1420","Sogndal","0000",,"V",200,52,252
"1420","Sogndal","0000",,"H",397,94,491
"1420","Sogndal","0000",,"FRP",425,87,512
"1421","Aurland","0000",,"A",192,52,244
"1421","Aurland","0000",,"SP",213,61,274
"1421","Aurland","0000",,"V",72,13,85
"1421","Aurland","0000",,"H",228,37,265
"1421","Aurland","0000",,"MDG",38,22,60
"1422","Lærdal","0000",,"A",250,55,305
"1422","Lærdal","0000",,"SV",127,46,173
"1422","Lærdal","0000",,"SP",254,91,345
"1422","Lærdal","0000",,"V",126,37,163
"1422","Lærdal","0000",,"H",163,55,218
"1424","Årdal","0000",,"A",1739,375,2114
"1424","Årdal","0000",,"SP",324,74,398
"1424","Årdal","0000",,"H",153,42,195
"1424","Årdal","0000",,"FRP",105,18,123
"1426","Luster","0000",,"A",686,231,917
"1426","Luster","0000",,"SV",46,17,63
"1426","Luster","0000",,"SP",680,162,842
"1426","Luster","0000",,"KRF",151,50,201
"1426","Luster","0000",,"V",145,52,197
"1426","Luster","0000",,"H",267,64,331
"1426","Luster","0000",,"FRP",293,56,349
"1428","Askvoll","0000",,"A",212,63,275
"1428","Askvoll","0000",,"SV",34,16,50
"1428","Askvoll","0000",,"SP",216,45,261
"1428","Askvoll","0000",,"KRF",91,27,118
"1428","Askvoll","0000",,"V",312,70,382
"1428","Askvoll","0000",,"H",376,93,469
"1428","Askvoll","0000",,"KYST",16,3,19
"1429","Fjaler","0000",,"A",562,71,633
"1429","Fjaler","0000",,"SV",60,18,78
"1429","Fjaler","0000",,"SP",224,33,257
"1429","Fjaler","0000",,"KRF",52,13,65
"1429","Fjaler","0000",,"V",142,30,172
"1429","Fjaler","0000",,"H",151,22,173
"1430","Gaular","0000",,"A",130,45,175
"1430","Gaular","0000",,"SV",44,26,70
"1430","Gaular","0000",,"SP",333,76,409
"1430","Gaular","0000",,"KRF",158,32,190
"1430","Gaular","0000",,"V",49,8,57
"1430","Gaular","0000",,"H",462,76,538
"1431","Jølster","0000",,"A",268,53,321
"1431","Jølster","0000",,"SV",84,23,107
"1431","Jølster","0000",,"SP",414,77,491
"1431","Jølster","0000",,"KRF",74,29,103
"1431","Jølster","0000",,"V",209,25,234
"1431","Jølster","0000",,"H",178,30,208
"1431","Jølster","0000",,"FRP",68,14,82
"1432","Førde","0000",,"A",1169,313,1482
"1432","Førde","0000",,"SV",425,120,545
"1432","Førde","0000",,"SP",500,110,610
"1432","Førde","0000",,"KRF",346,122,468
"1432","Førde","0000",,"V",426,83,509
"1432","Førde","0000",,"H",1283,282,1565
"1432","Førde","0000",,"FRP",330,77,407
"1433","Naustdal","0000",,"A",349,75,424
"1433","Naustdal","0000",,"SV",81,23,104
"1433","Naustdal","0000",,"RØDT",50,7,57
"1433","Naustdal","0000",,"SP",246,39,285
"1433","Naustdal","0000",,"KRF",63,15,78
"1433","Naustdal","0000",,"V",130,29,159
"1433","Naustdal","0000",,"H",248,58,306
"1433","Naustdal","0000",,"FRP",48,18,66
"1438","Bremanger","0000",,"A",319,173,492
"1438","Bremanger","0000",,"SV",55,58,113
"1438","Bremanger","0000",,"SP",315,93,408
"1438","Bremanger","0000",,"KRF",81,25,106
"1438","Bremanger","0000",,"V",157,30,187
"1438","Bremanger","0000",,"H",297,142,439
"1438","Bremanger","0000",,"FRP",110,68,178
"1439","Vågsøy","0000",,"A",240,72,312
"1439","Vågsøy","0000",,"SV",113,40,153
"1439","Vågsøy","0000",,"SP",377,91,468
"1439","Vågsøy","0000",,"KRF",140,46,186
"1439","Vågsøy","0000",,"V",341,84,425
"1439","Vågsøy","0000",,"H",632,227,859
"1439","Vågsøy","0000",,"FRP",270,115,385
"1439","Vågsøy","0000",,"B",84,6,90
"1441","Selje","0000",,"A",41,16,57
"1441","Selje","0000",,"SP",70,24,94
"1441","Selje","0000",,"KRF",189,45,234
"1441","Selje","0000",,"V",42,10,52
"1441","Selje","0000",,"H",184,44,228
"1441","Selje","0000",,"FRP",226,69,295
"1441","Selje","0000",,"SELTL",317,72,389
"1443","Eid","0000",,"A",203,69,272
"1443","Eid","0000",,"SV",61,25,86
"1443","Eid","0000",,"SP",586,81,667
"1443","Eid","0000",,"KRF",124,41,165
"1443","Eid","0000",,"V",1088,318,1406
"1443","Eid","0000",,"H",342,83,425
"1443","Eid","0000",,"FRP",123,50,173
"1444","Hornindal","0000",,"A",62,15,77
"1444","Hornindal","0000",,"SP",221,34,255
"1444","Hornindal","0000",,"V",102,25,127
"1444","Hornindal","0000",,"H",183,35,218
"1445","Gloppen","0000",,"A",230,73,303
"1445","Gloppen","0000",,"SV",118,41,159
"1445","Gloppen","0000",,"SP",875,169,1044
"1445","Gloppen","0000",,"KRF",289,76,365
"1445","Gloppen","0000",,"V",138,52,190
"1445","Gloppen","0000",,"H",467,115,582
"1445","Gloppen","0000",,"SAMDEM",339,67,406
"1449","Stryn","0000",,"A",462,102,564
"1449","Stryn","0000",,"SP",795,112,907
"1449","Stryn","0000",,"KRF",233,35,268
"1449","Stryn","0000",,"V",166,34,200
"1449","Stryn","0000",,"H",879,138,1017
"1449","Stryn","0000",,"FRP",192,37,229
"1502","Molde","0000",,"A",1693,495,2188
"1502","Molde","0000",,"SV",488,190,678
"1502","Molde","0000",,"RØDT",59,25,84
"1502","Molde","0000",,"SP",619,112,731
"1502","Molde","0000",,"KRF",827,247,1074
"1502","Molde","0000",,"V",1253,261,1514
"1502","Molde","0000",,"H",3484,982,4466
"1502","Molde","0000",,"FRP",1050,303,1353
"1502","Molde","0000",,"DEMN",14,2,16
"1502","Molde","0000",,"KYST",38,7,45
"1504","Ålesund","0000",,"A",2941,1819,4760
"1504","Ålesund","0000",,"SV",322,210,532
"1504","Ålesund","0000",,"RØDT",108,63,171
"1504","Ålesund","0000",,"SP",166,91,257
"1504","Ålesund","0000",,"KRF",1307,611,1918
"1504","Ålesund","0000",,"V",1052,457,1509
"1504","Ålesund","0000",,"H",3447,2275,5722
"1504","Ålesund","0000",,"FRP",2669,1777,4446
"1504","Ålesund","0000",,"DEMN",27,14,41
"1504","Ålesund","0000",,"PP",138,82,220
"1504","Ålesund","0000",,"TVPÅL",627,261,888
"1505","Kristiansund","0000",,"A",4530,1200,5730
"1505","Kristiansund","0000",,"SV",180,50,230
"1505","Kristiansund","0000",,"RØDT",191,54,245
"1505","Kristiansund","0000",,"SP",228,40,268
"1505","Kristiansund","0000",,"KRF",266,74,340
"1505","Kristiansund","0000",,"V",435,100,535
"1505","Kristiansund","0000",,"H",1550,354,1904
"1505","Kristiansund","0000",,"FRP",1500,459,1959
"1505","Kristiansund","0000",,"DEMN",19,0,19
"1505","Kristiansund","0000",,"MDG",39,11,50
"1511","Vanylven","0000",,"A",242,75,317
"1511","Vanylven","0000",,"SP",331,64,395
"1511","Vanylven","0000",,"KRF",280,48,328
"1511","Vanylven","0000",,"V",111,28,139
"1511","Vanylven","0000",,"H",185,45,230
"1511","Vanylven","0000",,"FRP",304,61,365
"1514","Sande","0000",,"A",101,40,141
"1514","Sande","0000",,"SP",108,21,129
"1514","Sande","0000",,"KRF",61,19,80
"1514","Sande","0000",,"V",80,14,94
"1514","Sande","0000",,"H",444,54,498
"1514","Sande","0000",,"FRP",101,35,136
"1514","Sande","0000",,"TVLKS_V",236,27,263
"1515","Herøy","0000",,"A",564,123,687
"1515","Herøy","0000",,"SV",39,18,57
"1515","Herøy","0000",,"KRF",533,102,635
"1515","Herøy","0000",,"V",86,8,94
"1515","Herøy","0000",,"H",1490,305,1795
"1515","Herøy","0000",,"FRP",273,102,375
"1515","Herøy","0000",,"FLSP",292,44,336
"1516","Ulstein","0000",,"A",661,123,784
"1516","Ulstein","0000",,"SV",79,16,95
"1516","Ulstein","0000",,"SP",169,19,188
"1516","Ulstein","0000",,"KRF",283,89,372
"1516","Ulstein","0000",,"V",372,50,422
"1516","Ulstein","0000",,"H",973,163,1136
"1516","Ulstein","0000",,"FRP",415,92,507
"1516","Ulstein","0000",,"KSP",26,10,36
"1517","Hareid","0000",,"A",195,55,250
"1517","Hareid","0000",,"SV",50,26,76
"1517","Hareid","0000",,"KRF",133,37,170
"1517","Hareid","0000",,"V",222,59,281
"1517","Hareid","0000",,"H",445,97,542
"1517","Hareid","0000",,"FRP",349,96,445
"1517","Hareid","0000",,"KSP",20,1,21
"1517","Hareid","0000",,"FOHAR",522,68,590
"1519","Volda","0000",,"A",518,151,669
"1519","Volda","0000",,"SV",273,96,369
"1519","Volda","0000",,"SP",436,83,519
"1519","Volda","0000",,"KRF",675,171,846
"1519","Volda","0000",,"V",425,100,525
"1519","Volda","0000",,"H",548,112,660
"1519","Volda","0000",,"FRP",626,141,767
"1519","Volda","0000",,"FERJA",265,55,320
"1520","Ørsta","0000",,"A",955,191,1146
"1520","Ørsta","0000",,"SV",105,29,134
"1520","Ørsta","0000",,"SP",722,97,819
"1520","Ørsta","0000",,"KRF",442,108,550
"1520","Ørsta","0000",,"V",276,77,353
"1520","Ørsta","0000",,"H",997,180,1177
"1520","Ørsta","0000",,"FRP",841,142,983
"1523","Ørskog","0000",,"A",212,49,261
"1523","Ørskog","0000",,"SP",207,21,228
"1523","Ørskog","0000",,"H",118,21,139
"1523","Ørskog","0000",,"FRP",306,45,351
"1523","Ørskog","0000",,"ØR_KRF_V",121,24,145
"1524","Norddal","0000",,"A",186,59,245
"1524","Norddal","0000",,"SV",21,7,28
"1524","Norddal","0000",,"SP",101,30,131
"1524","Norddal","0000",,"FRP",37,17,54
"1524","Norddal","0000",,"NOLI",226,59,285
"1524","Norddal","0000",,"TVLN",121,29,150
"1525","Stranda","0000",,"A",189,81,270
"1525","Stranda","0000",,"SV",32,19,51
"1525","Stranda","0000",,"SP",570,162,732
"1525","Stranda","0000",,"KRF",120,40,160
"1525","Stranda","0000",,"V",102,24,126
"1525","Stranda","0000",,"H",209,74,283
"1525","Stranda","0000",,"FRP",605,200,805
"1526","Stordal","0000",,"A",82,25,107
"1526","Stordal","0000",,"SP",48,7,55
"1526","Stordal","0000",,"KRF",33,7,40
"1526","Stordal","0000",,"H",200,34,234
"1526","Stordal","0000",,"FRP",41,4,45
"1528","Sykkylven","0000",,"A",564,123,687
"1528","Sykkylven","0000",,"SV",91,29,120
"1528","Sykkylven","0000",,"SP",366,29,395
"1528","Sykkylven","0000",,"KRF",336,71,407
"1528","Sykkylven","0000",,"V",254,44,298
"1528","Sykkylven","0000",,"H",804,118,922
"1528","Sykkylven","0000",,"FRP",766,107,873
"1529","Skodje","0000",,"A",292,57,349
"1529","Skodje","0000",,"SP",308,48,356
"1529","Skodje","0000",,"KRF",188,35,223
"1529","Skodje","0000",,"V",132,12,144
"1529","Skodje","0000",,"H",333,52,385
"1529","Skodje","0000",,"FRP",388,45,433
"1531","Sula","0000",,"A",504,105,609
"1531","Sula","0000",,"SP",60,10,70
"1531","Sula","0000",,"KRF",393,56,449
"1531","Sula","0000",,"V",204,38,242
"1531","Sula","0000",,"H",595,98,693
"1531","Sula","0000",,"FRP",968,151,1119
"1531","Sula","0000",,"UAVH",484,57,541
"1532","Giske","0000",,"A",304,64,368
"1532","Giske","0000",,"SP",159,29,188
"1532","Giske","0000",,"KRF",1045,182,1227
"1532","Giske","0000",,"V",443,73,516
"1532","Giske","0000",,"H",623,118,741
"1532","Giske","0000",,"FRP",287,61,348
"1534","Haram","0000",,"A",542,82,624
"1534","Haram","0000",,"SP",630,69,699
"1534","Haram","0000",,"KRF",326,59,385
"1534","Haram","0000",,"V",128,26,154
"1534","Haram","0000",,"H",1019,160,1179
"1534","Haram","0000",,"FRP",441,66,507
"1534","Haram","0000",,"UVH",562,59,621
"1535","Vestnes","0000",,"A",359,121,480
"1535","Vestnes","0000",,"SV",60,17,77
"1535","Vestnes","0000",,"SP",491,83,574
"1535","Vestnes","0000",,"KRF",272,48,320
"1535","Vestnes","0000",,"V",500,95,595
"1535","Vestnes","0000",,"H",518,133,651
"1535","Vestnes","0000",,"FRP",381,106,487
"1539","Rauma","0000",,"A",564,215,779
"1539","Rauma","0000",,"SV",125,59,184
"1539","Rauma","0000",,"SP",612,167,779
"1539","Rauma","0000",,"KRF",237,90,327
"1539","Rauma","0000",,"V",177,62,239
"1539","Rauma","0000",,"H",462,137,599
"1539","Rauma","0000",,"FRP",332,130,462
"1543","Nesset","0000",,"A",434,67,501
"1543","Nesset","0000",,"SP",187,42,229
"1543","Nesset","0000",,"KRF",85,20,105
"1543","Nesset","0000",,"V",39,9,48
"1543","Nesset","0000",,"H",401,76,477
"1543","Nesset","0000",,"FRP",66,18,84
"1543","Nesset","0000",,"IL",56,13,69
"1545","Midsund","0000",,"SP",122,25,147
"1545","Midsund","0000",,"KRF",105,15,120
"1545","Midsund","0000",,"V",143,27,170
"1545","Midsund","0000",,"H",167,48,215
"1545","Midsund","0000",,"FRP",203,52,255
"1546","Sandøy","0000",,"A",153,42,195
"1546","Sandøy","0000",,"V",150,25,175
"1546","Sandøy","0000",,"H",201,54,255
"1546","Sandøy","0000",,"FRP",19,7,26
"1547","Aukra","0000",,"A",419,165,584
"1547","Aukra","0000",,"SV",51,10,61
"1547","Aukra","0000",,"SP",74,16,90
"1547","Aukra","0000",,"KRF",155,39,194
"1547","Aukra","0000",,"V",74,16,90
"1547","Aukra","0000",,"H",187,20,207
"1547","Aukra","0000",,"FRP",109,36,145
"1547","Aukra","0000",,"AUKRA",179,36,215
"1548","Fræna","0000",,"A",615,117,732
"1548","Fræna","0000",,"SP",875,82,957
"1548","Fræna","0000",,"KRF",368,74,442
"1548","Fræna","0000",,"V",186,33,219
"1548","Fræna","0000",,"H",886,135,1021
"1548","Fræna","0000",,"FRP",587,132,719
"1551","Eide","0000",,"A",476,67,543
"1551","Eide","0000",,"SV",19,5,24
"1551","Eide","0000",,"SP",159,28,187
"1551","Eide","0000",,"KRF",78,15,93
"1551","Eide","0000",,"V",145,25,170
"1551","Eide","0000",,"H",459,71,530
"1551","Eide","0000",,"FRP",103,24,127
"1554","Averøy","0000",,"A",685,158,843
"1554","Averøy","0000",,"SV",54,20,74
"1554","Averøy","0000",,"SP",319,59,378
"1554","Averøy","0000",,"KRF",140,43,183
"1554","Averøy","0000",,"V",300,68,368
"1554","Averøy","0000",,"H",292,63,355
"1554","Averøy","0000",,"FRP",376,97,473
"1557","Gjemnes","0000",,"A",230,55,285
"1557","Gjemnes","0000",,"SV",41,10,51
"1557","Gjemnes","0000",,"SP",231,26,257
"1557","Gjemnes","0000",,"KRF",293,67,360
"1557","Gjemnes","0000",,"V",67,6,73
"1557","Gjemnes","0000",,"H",174,39,213
"1557","Gjemnes","0000",,"FRP",136,21,157
"1560","Tingvoll","0000",,"A",382,88,470
"1560","Tingvoll","0000",,"SP",345,63,408
"1560","Tingvoll","0000",,"KRF",92,23,115
"1560","Tingvoll","0000",,"V",91,27,118
"1560","Tingvoll","0000",,"H",225,25,250
"1560","Tingvoll","0000",,"FRP",143,38,181
"1563","Sunndal","0000",,"A",1716,442,2158
"1563","Sunndal","0000",,"SV",108,65,173
"1563","Sunndal","0000",,"SP",248,41,289
"1563","Sunndal","0000",,"KRF",122,41,163
"1563","Sunndal","0000",,"V",112,24,136
"1563","Sunndal","0000",,"H",326,56,382
"1563","Sunndal","0000",,"FRP",350,75,425
"1566","Surnadal","0000",,"A",1144,220,1364
"1566","Surnadal","0000",,"SV",50,25,75
"1566","Surnadal","0000",,"SP",743,103,846
"1566","Surnadal","0000",,"KRF",107,25,132
"1566","Surnadal","0000",,"V",24,6,30
"1566","Surnadal","0000",,"H",192,32,224
"1566","Surnadal","0000",,"FRP",124,33,157
"1567","Rindal","0000",,"A",262,65,327
"1567","Rindal","0000",,"SP",563,110,673
"1567","Rindal","0000",,"KRF",36,15,51
"1567","Rindal","0000",,"H",74,18,92
"1571","Halsa","0000",,"A",114,52,166
"1571","Halsa","0000",,"SP",313,69,382
"1571","Halsa","0000",,"H",104,16,120
"1571","Halsa","0000",,"FRP",63,5,68
"1571","Halsa","0000",,"TB",108,34,142
"1573","Smøla","0000",,"A",328,86,414
"1573","Smøla","0000",,"SV",32,14,46
"1573","Smøla","0000",,"SP",76,22,98
"1573","Smøla","0000",,"V",197,44,241
"1573","Smøla","0000",,"H",285,86,371
"1573","Smøla","0000",,"FRP",38,21,59
"1576","Aure","0000",,"A",342,109,451
"1576","Aure","0000",,"SP",392,91,483
"1576","Aure","0000",,"KRF",75,23,98
"1576","Aure","0000",,"V",220,60,280
"1576","Aure","0000",,"H",248,56,304
"1576","Aure","0000",,"FRP",56,34,90
"1601","Trondheim","FORH","Forhånd ikke kretsfordelt","A",0,72,72
"1601","Trondheim","FORH","Forhånd ikke kretsfordelt","SV",0,33,33
"1601","Trondheim","FORH","Forhånd ikke kretsfordelt","RØDT",0,8,8
"1601","Trondheim","FORH","Forhånd ikke kretsfordelt","SP",0,5,5
"1601","Trondheim","FORH","Forhånd ikke kretsfordelt","KRF",0,5,5
"1601","Trondheim","FORH","Forhånd ikke kretsfordelt","V",0,23,23
"1601","Trondheim","FORH","Forhånd ikke kretsfordelt","H",0,54,54
"1601","Trondheim","FORH","Forhånd ikke kretsfordelt","FRP",0,10,10
"1601","Trondheim","FORH","Forhånd ikke kretsfordelt","DEMN",0,1,1
"1601","Trondheim","FORH","Forhånd ikke kretsfordelt","MDG",0,11,11
"1601","Trondheim","FORH","Forhånd ikke kretsfordelt","PP",0,4,4
"1601","Trondheim","FREM","Fremmede ikke kretsfordelt","A",775,0,775
"1601","Trondheim","FREM","Fremmede ikke kretsfordelt","SV",155,0,155
"1601","Trondheim","FREM","Fremmede ikke kretsfordelt","RØDT",67,0,67
"1601","Trondheim","FREM","Fremmede ikke kretsfordelt","SP",40,0,40
"1601","Trondheim","FREM","Fremmede ikke kretsfordelt","KRF",51,0,51
"1601","Trondheim","FREM","Fremmede ikke kretsfordelt","V",180,0,180
"1601","Trondheim","FREM","Fremmede ikke kretsfordelt","H",473,0,473
"1601","Trondheim","FREM","Fremmede ikke kretsfordelt","FRP",147,0,147
"1601","Trondheim","FREM","Fremmede ikke kretsfordelt","DEMN",19,0,19
"1601","Trondheim","FREM","Fremmede ikke kretsfordelt","KSP",5,0,5
"1601","Trondheim","FREM","Fremmede ikke kretsfordelt","MDG",106,0,106
"1601","Trondheim","FREM","Fremmede ikke kretsfordelt","NKP",9,0,9
"1601","Trondheim","FREM","Fremmede ikke kretsfordelt","PP",12,0,12
"1601","Trondheim","VALG","Valgting ikke kretsfordelt","A",28,0,28
"1601","Trondheim","VALG","Valgting ikke kretsfordelt","SV",5,0,5
"1601","Trondheim","VALG","Valgting ikke kretsfordelt","RØDT",1,0,1
"1601","Trondheim","VALG","Valgting ikke kretsfordelt","KRF",3,0,3
"1601","Trondheim","VALG","Valgting ikke kretsfordelt","V",3,0,3
"1601","Trondheim","VALG","Valgting ikke kretsfordelt","H",12,0,12
"1601","Trondheim","VALG","Valgting ikke kretsfordelt","FRP",3,0,3
"1601","Trondheim","VALG","Valgting ikke kretsfordelt","MDG",2,0,2
"1601","Trondheim","VALG","Valgting ikke kretsfordelt","PP",4,0,4
"1601","Trondheim","0001","Sverresborg","A",1025,404,1429
"1601","Trondheim","0001","Sverresborg","SV",147,71,218
"1601","Trondheim","0001","Sverresborg","RØDT",85,40,125
"1601","Trondheim","0001","Sverresborg","SP",45,19,64
"1601","Trondheim","0001","Sverresborg","KRF",107,31,138
"1601","Trondheim","0001","Sverresborg","V",176,61,237
"1601","Trondheim","0001","Sverresborg","H",667,230,897
"1601","Trondheim","0001","Sverresborg","FRP",152,81,233
"1601","Trondheim","0001","Sverresborg","DEMN",16,8,24
"1601","Trondheim","0001","Sverresborg","KSP",2,0,2
"1601","Trondheim","0001","Sverresborg","MDG",79,32,111
"1601","Trondheim","0001","Sverresborg","NKP",4,1,5
"1601","Trondheim","0001","Sverresborg","PP",29,10,39
"1601","Trondheim","0002","Ila","A",650,337,987
"1601","Trondheim","0002","Ila","SV",165,84,249
"1601","Trondheim","0002","Ila","RØDT",110,41,151
"1601","Trondheim","0002","Ila","SP",43,12,55
"1601","Trondheim","0002","Ila","KRF",42,15,57
"1601","Trondheim","0002","Ila","V",161,81,242
"1601","Trondheim","0002","Ila","H",477,208,685
"1601","Trondheim","0002","Ila","FRP",118,73,191
"1601","Trondheim","0002","Ila","DEMN",5,4,9
"1601","Trondheim","0002","Ila","MDG",71,40,111
"1601","Trondheim","0002","Ila","NKP",1,3,4
"1601","Trondheim","0002","Ila","PP",15,11,26
"1601","Trondheim","0003","Kalvskinnet","A",263,374,637
"1601","Trondheim","0003","Kalvskinnet","SV",103,86,189
"1601","Trondheim","0003","Kalvskinnet","RØDT",69,47,116
"1601","Trondheim","0003","Kalvskinnet","SP",7,14,21
"1601","Trondheim","0003","Kalvskinnet","KRF",18,27,45
"1601","Trondheim","0003","Kalvskinnet","V",114,86,200
"1601","Trondheim","0003","Kalvskinnet","H",278,258,536
"1601","Trondheim","0003","Kalvskinnet","FRP",67,85,152
"1601","Trondheim","0003","Kalvskinnet","DEMN",4,6,10
"1601","Trondheim","0003","Kalvskinnet","KSP",2,2,4
"1601","Trondheim","0003","Kalvskinnet","MDG",64,54,118
"1601","Trondheim","0003","Kalvskinnet","NKP",3,3,6
"1601","Trondheim","0003","Kalvskinnet","PP",6,25,31
"1601","Trondheim","0004","Elgeseter/Øya","A",361,265,626
"1601","Trondheim","0004","Elgeseter/Øya","SV",102,58,160
"1601","Trondheim","0004","Elgeseter/Øya","RØDT",70,29,99
"1601","Trondheim","0004","Elgeseter/Øya","SP",16,7,23
"1601","Trondheim","0004","Elgeseter/Øya","KRF",23,13,36
"1601","Trondheim","0004","Elgeseter/Øya","V",130,84,214
"1601","Trondheim","0004","Elgeseter/Øya","H",230,145,375
"1601","Trondheim","0004","Elgeseter/Øya","FRP",49,38,87
"1601","Trondheim","0004","Elgeseter/Øya","DEMN",7,4,11
"1601","Trondheim","0004","Elgeseter/Øya","KSP",1,0,1
"1601","Trondheim","0004","Elgeseter/Øya","MDG",65,33,98
"1601","Trondheim","0004","Elgeseter/Øya","NKP",4,2,6
"1601","Trondheim","0004","Elgeseter/Øya","PP",10,8,18
"1601","Trondheim","0005","Singsaker","A",298,186,484
"1601","Trondheim","0005","Singsaker","SV",111,64,175
"1601","Trondheim","0005","Singsaker","RØDT",60,30,90
"1601","Trondheim","0005","Singsaker","SP",20,6,26
"1601","Trondheim","0005","Singsaker","KRF",17,12,29
"1601","Trondheim","0005","Singsaker","V",102,41,143
"1601","Trondheim","0005","Singsaker","H",360,231,591
"1601","Trondheim","0005","Singsaker","FRP",51,30,81
"1601","Trondheim","0005","Singsaker","DEMN",2,4,6
"1601","Trondheim","0005","Singsaker","KSP",1,0,1
"1601","Trondheim","0005","Singsaker","MDG",49,17,66
"1601","Trondheim","0005","Singsaker","NKP",2,1,3
"1601","Trondheim","0005","Singsaker","PP",3,3,6
"1601","Trondheim","0006","Rosenborg","A",730,327,1057
"1601","Trondheim","0006","Rosenborg","SV",209,87,296
"1601","Trondheim","0006","Rosenborg","RØDT",116,54,170
"1601","Trondheim","0006","Rosenborg","SP",22,13,35
"1601","Trondheim","0006","Rosenborg","KRF",42,19,61
"1601","Trondheim","0006","Rosenborg","V",176,73,249
"1601","Trondheim","0006","Rosenborg","H",559,195,754
"1601","Trondheim","0006","Rosenborg","FRP",119,57,176
"1601","Trondheim","0006","Rosenborg","DEMN",18,6,24
"1601","Trondheim","0006","Rosenborg","KSP",5,1,6
"1601","Trondheim","0006","Rosenborg","MDG",131,44,175
"1601","Trondheim","0006","Rosenborg","NKP",0,1,1
"1601","Trondheim","0006","Rosenborg","PP",22,10,32
"1601","Trondheim","0007","Lademoen","A",409,295,704
"1601","Trondheim","0007","Lademoen","SV",141,69,210
"1601","Trondheim","0007","Lademoen","RØDT",75,36,111
"1601","Trondheim","0007","Lademoen","SP",22,20,42
"1601","Trondheim","0007","Lademoen","KRF",28,17,45
"1601","Trondheim","0007","Lademoen","V",116,50,166
"1601","Trondheim","0007","Lademoen","H",239,139,378
"1601","Trondheim","0007","Lademoen","FRP",68,55,123
"1601","Trondheim","0007","Lademoen","DEMN",5,6,11
"1601","Trondheim","0007","Lademoen","KSP",1,1,2
"1601","Trondheim","0007","Lademoen","MDG",224,51,275
"1601","Trondheim","0007","Lademoen","NKP",2,3,5
"1601","Trondheim","0007","Lademoen","PP",8,12,20
"1601","Trondheim","0008","Tonstad","A",1107,548,1655
"1601","Trondheim","0008","Tonstad","SV",84,42,126
"1601","Trondheim","0008","Tonstad","RØDT",54,25,79
"1601","Trondheim","0008","Tonstad","SP",43,32,75
"1601","Trondheim","0008","Tonstad","KRF",99,52,151
"1601","Trondheim","0008","Tonstad","V",94,52,146
"1601","Trondheim","0008","Tonstad","H",733,322,1055
"1601","Trondheim","0008","Tonstad","FRP",281,116,397
"1601","Trondheim","0008","Tonstad","DEMN",10,6,16
"1601","Trondheim","0008","Tonstad","KSP",9,1,10
"1601","Trondheim","0008","Tonstad","MDG",23,8,31
"1601","Trondheim","0008","Tonstad","NKP",4,4,8
"1601","Trondheim","0008","Tonstad","PP",39,25,64
"1601","Trondheim","0009","Lade","A",730,449,1179
"1601","Trondheim","0009","Lade","SV",120,62,182
"1601","Trondheim","0009","Lade","RØDT",84,36,120
"1601","Trondheim","0009","Lade","SP",20,20,40
"1601","Trondheim","0009","Lade","KRF",44,16,60
"1601","Trondheim","0009","Lade","V",114,37,151
"1601","Trondheim","0009","Lade","H",511,258,769
"1601","Trondheim","0009","Lade","FRP",112,96,208
"1601","Trondheim","0009","Lade","DEMN",9,8,17
"1601","Trondheim","0009","Lade","KSP",1,0,1
"1601","Trondheim","0009","Lade","MDG",47,34,81
"1601","Trondheim","0009","Lade","NKP",3,0,3
"1601","Trondheim","0009","Lade","PP",29,26,55
"1601","Trondheim","0010","Trolla","A",87,31,118
"1601","Trondheim","0010","Trolla","SV",8,3,11
"1601","Trondheim","0010","Trolla","RØDT",13,1,14
"1601","Trondheim","0010","Trolla","SP",2,2,4
"1601","Trondheim","0010","Trolla","KRF",6,1,7
"1601","Trondheim","0010","Trolla","V",16,2,18
"1601","Trondheim","0010","Trolla","H",60,18,78
"1601","Trondheim","0010","Trolla","FRP",21,6,27
"1601","Trondheim","0010","Trolla","DEMN",4,1,5
"1601","Trondheim","0010","Trolla","MDG",6,4,10
"1601","Trondheim","0010","Trolla","PP",1,0,1
"1601","Trondheim","0011","Ranheim","A",691,260,951
"1601","Trondheim","0011","Ranheim","SV",69,34,103
"1601","Trondheim","0011","Ranheim","RØDT",26,16,42
"1601","Trondheim","0011","Ranheim","SP",27,12,39
"1601","Trondheim","0011","Ranheim","KRF",28,14,42
"1601","Trondheim","0011","Ranheim","V",67,25,92
"1601","Trondheim","0011","Ranheim","H",509,172,681
"1601","Trondheim","0011","Ranheim","FRP",131,62,193
"1601","Trondheim","0011","Ranheim","DEMN",17,5,22
"1601","Trondheim","0011","Ranheim","MDG",19,8,27
"1601","Trondheim","0011","Ranheim","NKP",5,0,5
"1601","Trondheim","0011","Ranheim","PP",22,9,31
"1601","Trondheim","0012","Charlottenlund","A",1084,421,1505
"1601","Trondheim","0012","Charlottenlund","SV",119,61,180
"1601","Trondheim","0012","Charlottenlund","RØDT",56,18,74
"1601","Trondheim","0012","Charlottenlund","SP",34,16,50
"1601","Trondheim","0012","Charlottenlund","KRF",36,33,69
"1601","Trondheim","0012","Charlottenlund","V",142,39,181
"1601","Trondheim","0012","Charlottenlund","H",775,258,1033
"1601","Trondheim","0012","Charlottenlund","FRP",192,66,258
"1601","Trondheim","0012","Charlottenlund","DEMN",12,6,18
"1601","Trondheim","0012","Charlottenlund","MDG",62,20,82
"1601","Trondheim","0012","Charlottenlund","NKP",2,0,2
"1601","Trondheim","0012","Charlottenlund","PP",29,11,40
"1601","Trondheim","0013","Strindheim","A",1032,454,1486
"1601","Trondheim","0013","Strindheim","SV",156,65,221
"1601","Trondheim","0013","Strindheim","RØDT",72,42,114
"1601","Trondheim","0013","Strindheim","SP",42,22,64
"1601","Trondheim","0013","Strindheim","KRF",60,30,90
"1601","Trondheim","0013","Strindheim","V",177,41,218
"1601","Trondheim","0013","Strindheim","H",762,287,1049
"1601","Trondheim","0013","Strindheim","FRP",201,86,287
"1601","Trondheim","0013","Strindheim","DEMN",11,6,17
"1601","Trondheim","0013","Strindheim","KSP",1,0,1
"1601","Trondheim","0013","Strindheim","MDG",60,22,82
"1601","Trondheim","0013","Strindheim","NKP",1,1,2
"1601","Trondheim","0013","Strindheim","PP",41,29,70
"1601","Trondheim","0014","Blussuvoll","A",531,252,783
"1601","Trondheim","0014","Blussuvoll","SV",138,69,207
"1601","Trondheim","0014","Blussuvoll","RØDT",45,22,67
"1601","Trondheim","0014","Blussuvoll","SP",22,12,34
"1601","Trondheim","0014","Blussuvoll","KRF",43,22,65
"1601","Trondheim","0014","Blussuvoll","V",121,52,173
"1601","Trondheim","0014","Blussuvoll","H",583,257,840
"1601","Trondheim","0014","Blussuvoll","FRP",100,63,163
"1601","Trondheim","0014","Blussuvoll","DEMN",4,2,6
"1601","Trondheim","0014","Blussuvoll","KSP",2,0,2
"1601","Trondheim","0014","Blussuvoll","MDG",58,15,73
"1601","Trondheim","0014","Blussuvoll","PP",14,4,18
"1601","Trondheim","0015","Nidarvoll","A",1180,496,1676
"1601","Trondheim","0015","Nidarvoll","SV",125,73,198
"1601","Trondheim","0015","Nidarvoll","RØDT",63,21,84
"1601","Trondheim","0015","Nidarvoll","SP",65,25,90
"1601","Trondheim","0015","Nidarvoll","KRF",109,61,170
"1601","Trondheim","0015","Nidarvoll","V",149,47,196
"1601","Trondheim","0015","Nidarvoll","H",924,314,1238
"1601","Trondheim","0015","Nidarvoll","FRP",268,112,380
"1601","Trondheim","0015","Nidarvoll","DEMN",14,10,24
"1601","Trondheim","0015","Nidarvoll","KSP",7,1,8
"1601","Trondheim","0015","Nidarvoll","MDG",39,20,59
"1601","Trondheim","0015","Nidarvoll","NKP",7,1,8
"1601","Trondheim","0015","Nidarvoll","PP",57,31,88
"1601","Trondheim","0016","Nardo","A",540,319,859
"1601","Trondheim","0016","Nardo","SV",76,48,124
"1601","Trondheim","0016","Nardo","RØDT",26,16,42
"1601","Trondheim","0016","Nardo","SP",15,11,26
"1601","Trondheim","0016","Nardo","KRF",33,37,70
"1601","Trondheim","0016","Nardo","V",122,50,172
"1601","Trondheim","0016","Nardo","H",415,175,590
"1601","Trondheim","0016","Nardo","FRP",111,76,187
"1601","Trondheim","0016","Nardo","DEMN",10,9,19
"1601","Trondheim","0016","Nardo","KSP",3,0,3
"1601","Trondheim","0016","Nardo","MDG",28,17,45
"1601","Trondheim","0016","Nardo","NKP",0,1,1
"1601","Trondheim","0016","Nardo","PP",16,17,33
"1601","Trondheim","0017","Åsvang","A",739,461,1200
"1601","Trondheim","0017","Åsvang","SV",120,57,177
"1601","Trondheim","0017","Åsvang","RØDT",46,32,78
"1601","Trondheim","0017","Åsvang","SP",36,20,56
"1601","Trondheim","0017","Åsvang","KRF",71,26,97
"1601","Trondheim","0017","Åsvang","V",113,54,167
"1601","Trondheim","0017","Åsvang","H",540,340,880
"1601","Trondheim","0017","Åsvang","FRP",161,105,266
"1601","Trondheim","0017","Åsvang","DEMN",3,6,9
"1601","Trondheim","0017","Åsvang","KSP",2,0,2
"1601","Trondheim","0017","Åsvang","MDG",32,18,50
"1601","Trondheim","0017","Åsvang","NKP",2,1,3
"1601","Trondheim","0017","Åsvang","PP",17,19,36
"1601","Trondheim","0018","Solbakken","A",140,35,175
"1601","Trondheim","0018","Solbakken","SV",22,8,30
"1601","Trondheim","0018","Solbakken","RØDT",15,3,18
"1601","Trondheim","0018","Solbakken","SP",11,6,17
"1601","Trondheim","0018","Solbakken","KRF",12,3,15
"1601","Trondheim","0018","Solbakken","V",18,4,22
"1601","Trondheim","0018","Solbakken","H",108,19,127
"1601","Trondheim","0018","Solbakken","FRP",66,9,75
"1601","Trondheim","0018","Solbakken","DEMN",16,1,17
"1601","Trondheim","0018","Solbakken","KSP",1,0,1
"1601","Trondheim","0018","Solbakken","MDG",8,1,9
"1601","Trondheim","0018","Solbakken","PP",3,1,4
"1601","Trondheim","0019","Bratsberg","A",121,26,147
"1601","Trondheim","0019","Bratsberg","SV",9,2,11
"1601","Trondheim","0019","Bratsberg","RØDT",4,3,7
"1601","Trondheim","0019","Bratsberg","SP",32,4,36
"1601","Trondheim","0019","Bratsberg","KRF",17,1,18
"1601","Trondheim","0019","Bratsberg","V",14,1,15
"1601","Trondheim","0019","Bratsberg","H",99,16,115
"1601","Trondheim","0019","Bratsberg","FRP",56,23,79
"1601","Trondheim","0019","Bratsberg","DEMN",5,1,6
"1601","Trondheim","0019","Bratsberg","KSP",4,0,4
"1601","Trondheim","0019","Bratsberg","MDG",1,1,2
"1601","Trondheim","0019","Bratsberg","PP",4,1,5
"1601","Trondheim","0020","Hoeggen","A",537,248,785
"1601","Trondheim","0020","Hoeggen","SV",61,35,96
"1601","Trondheim","0020","Hoeggen","RØDT",48,16,64
"1601","Trondheim","0020","Hoeggen","SP",30,21,51
"1601","Trondheim","0020","Hoeggen","KRF",62,31,93
"1601","Trondheim","0020","Hoeggen","V",76,36,112
"1601","Trondheim","0020","Hoeggen","H",335,145,480
"1601","Trondheim","0020","Hoeggen","FRP",137,55,192
"1601","Trondheim","0020","Hoeggen","DEMN",6,3,9
"1601","Trondheim","0020","Hoeggen","KSP",3,0,3
"1601","Trondheim","0020","Hoeggen","MDG",23,12,35
"1601","Trondheim","0020","Hoeggen","NKP",0,1,1
"1601","Trondheim","0020","Hoeggen","PP",15,12,27
"1601","Trondheim","0021","Hallset","A",591,231,822
"1601","Trondheim","0021","Hallset","SV",55,19,74
"1601","Trondheim","0021","Hallset","RØDT",27,10,37
"1601","Trondheim","0021","Hallset","SP",21,5,26
"1601","Trondheim","0021","Hallset","KRF",51,20,71
"1601","Trondheim","0021","Hallset","V",60,20,80
"1601","Trondheim","0021","Hallset","H",452,120,572
"1601","Trondheim","0021","Hallset","FRP",180,76,256
"1601","Trondheim","0021","Hallset","DEMN",14,6,20
"1601","Trondheim","0021","Hallset","KSP",2,0,2
"1601","Trondheim","0021","Hallset","MDG",21,9,30
"1601","Trondheim","0021","Hallset","NKP",2,0,2
"1601","Trondheim","0021","Hallset","PP",19,10,29
"1601","Trondheim","0022","Byåsen","A",1065,421,1486
"1601","Trondheim","0022","Byåsen","SV",117,44,161
"1601","Trondheim","0022","Byåsen","RØDT",73,28,101
"1601","Trondheim","0022","Byåsen","SP",42,23,65
"1601","Trondheim","0022","Byåsen","KRF",99,43,142
"1601","Trondheim","0022","Byåsen","V",165,54,219
"1601","Trondheim","0022","Byåsen","H",842,274,1116
"1601","Trondheim","0022","Byåsen","FRP",218,116,334
"1601","Trondheim","0022","Byåsen","DEMN",8,2,10
"1601","Trondheim","0022","Byåsen","KSP",4,1,5
"1601","Trondheim","0022","Byåsen","MDG",53,26,79
"1601","Trondheim","0022","Byåsen","NKP",3,1,4
"1601","Trondheim","0022","Byåsen","PP",17,18,35
"1601","Trondheim","0023","Romolslia","A",368,118,486
"1601","Trondheim","0023","Romolslia","SV",41,12,53
"1601","Trondheim","0023","Romolslia","RØDT",30,7,37
"1601","Trondheim","0023","Romolslia","SP",17,1,18
"1601","Trondheim","0023","Romolslia","KRF",12,5,17
"1601","Trondheim","0023","Romolslia","V",37,13,50
"1601","Trondheim","0023","Romolslia","H",225,51,276
"1601","Trondheim","0023","Romolslia","FRP",163,41,204
"1601","Trondheim","0023","Romolslia","DEMN",8,1,9
"1601","Trondheim","0023","Romolslia","KSP",0,1,1
"1601","Trondheim","0023","Romolslia","MDG",13,7,20
"1601","Trondheim","0023","Romolslia","NKP",2,0,2
"1601","Trondheim","0023","Romolslia","PP",10,5,15
"1601","Trondheim","0024","Breidablikk","A",428,182,610
"1601","Trondheim","0024","Breidablikk","SV",35,14,49
"1601","Trondheim","0024","Breidablikk","RØDT",15,5,20
"1601","Trondheim","0024","Breidablikk","SP",16,7,23
"1601","Trondheim","0024","Breidablikk","KRF",46,18,64
"1601","Trondheim","0024","Breidablikk","V",38,15,53
"1601","Trondheim","0024","Breidablikk","H",297,119,416
"1601","Trondheim","0024","Breidablikk","FRP",138,52,190
"1601","Trondheim","0024","Breidablikk","DEMN",5,5,10
"1601","Trondheim","0024","Breidablikk","KSP",3,0,3
"1601","Trondheim","0024","Breidablikk","MDG",4,6,10
"1601","Trondheim","0024","Breidablikk","NKP",1,1,2
"1601","Trondheim","0024","Breidablikk","PP",11,4,15
"1601","Trondheim","0025","Sjetne","A",771,228,999
"1601","Trondheim","0025","Sjetne","SV",70,16,86
"1601","Trondheim","0025","Sjetne","RØDT",40,9,49
"1601","Trondheim","0025","Sjetne","SP",38,13,51
"1601","Trondheim","0025","Sjetne","KRF",36,10,46
"1601","Trondheim","0025","Sjetne","V",61,32,93
"1601","Trondheim","0025","Sjetne","H",542,150,692
"1601","Trondheim","0025","Sjetne","FRP",182,63,245
"1601","Trondheim","0025","Sjetne","DEMN",10,1,11
"1601","Trondheim","0025","Sjetne","KSP",0,2,2
"1601","Trondheim","0025","Sjetne","MDG",23,2,25
"1601","Trondheim","0025","Sjetne","NKP",2,0,2
"1601","Trondheim","0025","Sjetne","PP",19,9,28
"1601","Trondheim","0026","Kolstad","A",853,593,1446
"1601","Trondheim","0026","Kolstad","SV",66,30,96
"1601","Trondheim","0026","Kolstad","RØDT",49,13,62
"1601","Trondheim","0026","Kolstad","SP",29,11,40
"1601","Trondheim","0026","Kolstad","KRF",52,26,78
"1601","Trondheim","0026","Kolstad","V",69,15,84
"1601","Trondheim","0026","Kolstad","H",396,144,540
"1601","Trondheim","0026","Kolstad","FRP",247,108,355
"1601","Trondheim","0026","Kolstad","DEMN",21,17,38
"1601","Trondheim","0026","Kolstad","KSP",3,3,6
"1601","Trondheim","0026","Kolstad","MDG",12,10,22
"1601","Trondheim","0026","Kolstad","NKP",2,5,7
"1601","Trondheim","0026","Kolstad","PP",31,22,53
"1601","Trondheim","0027","Flatåsen","A",1020,344,1364
"1601","Trondheim","0027","Flatåsen","SV",84,41,125
"1601","Trondheim","0027","Flatåsen","RØDT",49,17,66
"1601","Trondheim","0027","Flatåsen","SP",42,9,51
"1601","Trondheim","0027","Flatåsen","KRF",46,21,67
"1601","Trondheim","0027","Flatåsen","V",92,22,114
"1601","Trondheim","0027","Flatåsen","H",495,167,662
"1601","Trondheim","0027","Flatåsen","FRP",207,73,280
"1601","Trondheim","0027","Flatåsen","DEMN",13,7,20
"1601","Trondheim","0027","Flatåsen","KSP",4,2,6
"1601","Trondheim","0027","Flatåsen","MDG",29,8,37
"1601","Trondheim","0027","Flatåsen","NKP",1,2,3
"1601","Trondheim","0027","Flatåsen","PP",24,10,34
"1601","Trondheim","0028","Nypvang","A",149,59,208
"1601","Trondheim","0028","Nypvang","SV",23,8,31
"1601","Trondheim","0028","Nypvang","RØDT",8,1,9
"1601","Trondheim","0028","Nypvang","SP",87,19,106
"1601","Trondheim","0028","Nypvang","KRF",29,7,36
"1601","Trondheim","0028","Nypvang","V",19,9,28
"1601","Trondheim","0028","Nypvang","H",197,49,246
"1601","Trondheim","0028","Nypvang","FRP",88,21,109
"1601","Trondheim","0028","Nypvang","DEMN",3,3,6
"1601","Trondheim","0028","Nypvang","KSP",2,1,3
"1601","Trondheim","0028","Nypvang","MDG",4,5,9
"1601","Trondheim","0028","Nypvang","PP",4,2,6
"1601","Trondheim","0029","Åsheim","A",688,255,943
"1601","Trondheim","0029","Åsheim","SV",56,19,75
"1601","Trondheim","0029","Åsheim","RØDT",18,7,25
"1601","Trondheim","0029","Åsheim","SP",34,8,42
"1601","Trondheim","0029","Åsheim","KRF",65,26,91
"1601","Trondheim","0029","Åsheim","V",42,15,57
"1601","Trondheim","0029","Åsheim","H",335,106,441
"1601","Trondheim","0029","Åsheim","FRP",215,61,276
"1601","Trondheim","0029","Åsheim","DEMN",12,5,17
"1601","Trondheim","0029","Åsheim","KSP",3,1,4
"1601","Trondheim","0029","Åsheim","MDG",34,9,43
"1601","Trondheim","0029","Åsheim","NKP",2,4,6
"1601","Trondheim","0029","Åsheim","PP",28,9,37
"1601","Trondheim","0030","Spongdal","A",125,32,157
"1601","Trondheim","0030","Spongdal","SV",12,1,13
"1601","Trondheim","0030","Spongdal","RØDT",8,0,8
"1601","Trondheim","0030","Spongdal","SP",110,8,118
"1601","Trondheim","0030","Spongdal","KRF",44,9,53
"1601","Trondheim","0030","Spongdal","V",18,0,18
"1601","Trondheim","0030","Spongdal","H",180,33,213
"1601","Trondheim","0030","Spongdal","FRP",76,11,87
"1601","Trondheim","0030","Spongdal","MDG",6,0,6
"1601","Trondheim","0030","Spongdal","PP",9,1,10
"1601","Trondheim","0031","Ugla","A",1244,514,1758
"1601","Trondheim","0031","Ugla","SV",147,73,220
"1601","Trondheim","0031","Ugla","RØDT",80,23,103
"1601","Trondheim","0031","Ugla","SP",39,13,52
"1601","Trondheim","0031","Ugla","KRF",80,34,114
"1601","Trondheim","0031","Ugla","V",157,57,214
"1601","Trondheim","0031","Ugla","H",929,316,1245
"1601","Trondheim","0031","Ugla","FRP",292,122,414
"1601","Trondheim","0031","Ugla","DEMN",16,6,22
"1601","Trondheim","0031","Ugla","KSP",4,1,5
"1601","Trondheim","0031","Ugla","MDG",88,18,106
"1601","Trondheim","0031","Ugla","NKP",3,0,3
"1601","Trondheim","0031","Ugla","PP",34,8,42
"1601","Trondheim","0032","Rye","A",197,38,235
"1601","Trondheim","0032","Rye","SV",14,14,28
"1601","Trondheim","0032","Rye","RØDT",12,3,15
"1601","Trondheim","0032","Rye","SP",99,14,113
"1601","Trondheim","0032","Rye","KRF",28,6,34
"1601","Trondheim","0032","Rye","V",23,5,28
"1601","Trondheim","0032","Rye","H",160,36,196
"1601","Trondheim","0032","Rye","FRP",82,23,105
"1601","Trondheim","0032","Rye","DEMN",6,2,8
"1601","Trondheim","0032","Rye","KSP",2,1,3
"1601","Trondheim","0032","Rye","MDG",9,3,12
"1601","Trondheim","0032","Rye","NKP",1,0,1
"1601","Trondheim","0032","Rye","PP",4,0,4
"1601","Trondheim","0033","Åsveien","A",407,168,575
"1601","Trondheim","0033","Åsveien","SV",85,46,131
"1601","Trondheim","0033","Åsveien","RØDT",44,15,59
"1601","Trondheim","0033","Åsveien","SP",28,5,33
"1601","Trondheim","0033","Åsveien","KRF",24,20,44
"1601","Trondheim","0033","Åsveien","V",106,41,147
"1601","Trondheim","0033","Åsveien","H",350,140,490
"1601","Trondheim","0033","Åsveien","FRP",71,35,106
"1601","Trondheim","0033","Åsveien","DEMN",11,4,15
"1601","Trondheim","0033","Åsveien","KSP",4,0,4
"1601","Trondheim","0033","Åsveien","MDG",39,16,55
"1601","Trondheim","0033","Åsveien","NKP",1,1,2
"1601","Trondheim","0033","Åsveien","PP",6,4,10
"1601","Trondheim","0034","Utleira","A",595,315,910
"1601","Trondheim","0034","Utleira","SV",83,35,118
"1601","Trondheim","0034","Utleira","RØDT",38,23,61
"1601","Trondheim","0034","Utleira","SP",27,11,38
"1601","Trondheim","0034","Utleira","KRF",51,15,66
"1601","Trondheim","0034","Utleira","V",74,20,94
"1601","Trondheim","0034","Utleira","H",352,131,483
"1601","Trondheim","0034","Utleira","FRP",144,74,218
"1601","Trondheim","0034","Utleira","DEMN",12,6,18
"1601","Trondheim","0034","Utleira","KSP",4,2,6
"1601","Trondheim","0034","Utleira","MDG",11,6,17
"1601","Trondheim","0034","Utleira","NKP",2,2,4
"1601","Trondheim","0034","Utleira","PP",12,18,30
"1601","Trondheim","0035","Stabbursmoen","A",767,300,1067
"1601","Trondheim","0035","Stabbursmoen","SV",59,22,81
"1601","Trondheim","0035","Stabbursmoen","RØDT",34,2,36
"1601","Trondheim","0035","Stabbursmoen","SP",51,5,56
"1601","Trondheim","0035","Stabbursmoen","KRF",78,29,107
"1601","Trondheim","0035","Stabbursmoen","V",63,19,82
"1601","Trondheim","0035","Stabbursmoen","H",641,158,799
"1601","Trondheim","0035","Stabbursmoen","FRP",211,73,284
"1601","Trondheim","0035","Stabbursmoen","DEMN",8,9,17
"1601","Trondheim","0035","Stabbursmoen","KSP",1,0,1
"1601","Trondheim","0035","Stabbursmoen","MDG",21,3,24
"1601","Trondheim","0035","Stabbursmoen","NKP",1,2,3
"1601","Trondheim","0035","Stabbursmoen","PP",26,11,37
"1601","Trondheim","0036","Brundalen","A",510,309,819
"1601","Trondheim","0036","Brundalen","SV",54,25,79
"1601","Trondheim","0036","Brundalen","RØDT",29,8,37
"1601","Trondheim","0036","Brundalen","SP",21,12,33
"1601","Trondheim","0036","Brundalen","KRF",31,19,50
"1601","Trondheim","0036","Brundalen","V",68,32,100
"1601","Trondheim","0036","Brundalen","H",373,179,552
"1601","Trondheim","0036","Brundalen","FRP",106,90,196
"1601","Trondheim","0036","Brundalen","DEMN",2,1,3
"1601","Trondheim","0036","Brundalen","KSP",3,1,4
"1601","Trondheim","0036","Brundalen","MDG",21,6,27
"1601","Trondheim","0036","Brundalen","NKP",2,0,2
"1601","Trondheim","0036","Brundalen","PP",13,14,27
"1601","Trondheim","0037","Eberg","A",564,473,1037
"1601","Trondheim","0037","Eberg","SV",92,45,137
"1601","Trondheim","0037","Eberg","RØDT",48,14,62
"1601","Trondheim","0037","Eberg","SP",31,16,47
"1601","Trondheim","0037","Eberg","KRF",63,32,95
"1601","Trondheim","0037","Eberg","V",107,56,163
"1601","Trondheim","0037","Eberg","H",413,267,680
"1601","Trondheim","0037","Eberg","FRP",100,98,198
"1601","Trondheim","0037","Eberg","DEMN",6,12,18
"1601","Trondheim","0037","Eberg","KSP",1,3,4
"1601","Trondheim","0037","Eberg","MDG",28,27,55
"1601","Trondheim","0037","Eberg","NKP",4,0,4
"1601","Trondheim","0037","Eberg","PP",16,21,37
"1601","Trondheim","0038","Møllenberg","A",350,205,555
"1601","Trondheim","0038","Møllenberg","SV",96,57,153
"1601","Trondheim","0038","Møllenberg","RØDT",60,40,100
"1601","Trondheim","0038","Møllenberg","SP",15,9,24
"1601","Trondheim","0038","Møllenberg","KRF",12,7,19
"1601","Trondheim","0038","Møllenberg","V",109,68,177
"1601","Trondheim","0038","Møllenberg","H",396,203,599
"1601","Trondheim","0038","Møllenberg","FRP",76,42,118
"1601","Trondheim","0038","Møllenberg","DEMN",4,4,8
"1601","Trondheim","0038","Møllenberg","MDG",59,27,86
"1601","Trondheim","0038","Møllenberg","NKP",5,0,5
"1601","Trondheim","0038","Møllenberg","PP",12,7,19
"1601","Trondheim","0039","Vikåsen","A",488,155,643
"1601","Trondheim","0039","Vikåsen","SV",49,14,63
"1601","Trondheim","0039","Vikåsen","RØDT",23,9,32
"1601","Trondheim","0039","Vikåsen","SP",20,12,32
"1601","Trondheim","0039","Vikåsen","KRF",23,4,27
"1601","Trondheim","0039","Vikåsen","V",47,21,68
"1601","Trondheim","0039","Vikåsen","H",361,98,459
"1601","Trondheim","0039","Vikåsen","FRP",76,36,112
"1601","Trondheim","0039","Vikåsen","DEMN",44,10,54
"1601","Trondheim","0039","Vikåsen","KSP",0,2,2
"1601","Trondheim","0039","Vikåsen","MDG",13,1,14
"1601","Trondheim","0039","Vikåsen","NKP",1,0,1
"1601","Trondheim","0039","Vikåsen","PP",5,2,7
"1612","Hemne","0000",,"A",851,186,1037
"1612","Hemne","0000",,"SP",262,59,321
"1612","Hemne","0000",,"KRF",83,23,106
"1612","Hemne","0000",,"H",163,30,193
"1612","Hemne","0000",,"FRP",137,46,183
"1612","Hemne","0000",,"HEMNELIS",159,41,200
"1613","Snillfjord","0000",,"A",126,28,154
"1613","Snillfjord","0000",,"SP",114,38,152
"1613","Snillfjord","0000",,"KRF",36,14,50
"1613","Snillfjord","0000",,"H",147,45,192
"1617","Hitra","0000",,"A",569,194,763
"1617","Hitra","0000",,"SV",74,31,105
"1617","Hitra","0000",,"SP",61,29,90
"1617","Hitra","0000",,"KRF",39,19,58
"1617","Hitra","0000",,"V",57,13,70
"1617","Hitra","0000",,"H",201,60,261
"1617","Hitra","0000",,"FRP",155,50,205
"1617","Hitra","0000",,"MDG",16,14,30
"1617","Hitra","0000",,"PP",252,86,338
"1620","Frøya","0000",,"A",631,161,792
"1620","Frøya","0000",,"SV",83,26,109
"1620","Frøya","0000",,"SP",66,9,75
"1620","Frøya","0000",,"KRF",39,7,46
"1620","Frøya","0000",,"V",285,66,351
"1620","Frøya","0000",,"H",144,20,164
"1620","Frøya","0000",,"FRP",337,80,417
"1621","Ørland","0000",,"A",301,107,408
"1621","Ørland","0000",,"SV",54,19,73
"1621","Ørland","0000",,"SP",701,170,871
"1621","Ørland","0000",,"V",147,44,191
"1621","Ørland","0000",,"H",593,190,783
"1621","Ørland","0000",,"FRP",172,67,239
"1622","Agdenes","0000",,"A",129,43,172
"1622","Agdenes","0000",,"SP",100,21,121
"1622","Agdenes","0000",,"KRF",31,14,45
"1622","Agdenes","0000",,"H",97,17,114
"1622","Agdenes","0000",,"FBU",239,63,302
"1622","Agdenes","0000",,"TVPAG",162,34,196
"1624","Rissa","0000",,"A",615,130,745
"1624","Rissa","0000",,"SV",85,21,106
"1624","Rissa","0000",,"SP",466,52,518
"1624","Rissa","0000",,"KRF",104,46,150
"1624","Rissa","0000",,"V",144,38,182
"1624","Rissa","0000",,"H",953,130,1083
"1624","Rissa","0000",,"FRP",240,38,278
"1624","Rissa","0000",,"DEMN",77,2,79
"1624","Rissa","0000",,"PP",144,29,173
"1627","Bjugn","0000",,"A",644,178,822
"1627","Bjugn","0000",,"SP",257,37,294
"1627","Bjugn","0000",,"KRF",149,26,175
"1627","Bjugn","0000",,"V",111,24,135
"1627","Bjugn","0000",,"H",202,44,246
"1627","Bjugn","0000",,"FRP",194,51,245
"1627","Bjugn","0000",,"BB",123,31,154
"1630","Åfjord","0000",,"A",505,163,668
"1630","Åfjord","0000",,"SV",22,8,30
"1630","Åfjord","0000",,"SP",318,65,383
"1630","Åfjord","0000",,"KRF",122,51,173
"1630","Åfjord","0000",,"V",27,11,38
"1630","Åfjord","0000",,"H",217,57,274
"1630","Åfjord","0000",,"FRP",109,35,144
"1632","Roan","0000",,"A",50,31,81
"1632","Roan","0000",,"SP",190,84,274
"1632","Roan","0000",,"KRF",25,15,40
"1632","Roan","0000",,"V",40,16,56
"1632","Roan","0000",,"H",110,39,149
"1633","Osen","0000",,"A",95,55,150
"1633","Osen","0000",,"SV",9,3,12
"1633","Osen","0000",,"SP",45,13,58
"1633","Osen","0000",,"H",20,5,25
"1633","Osen","0000",,"FRP",26,22,48
"1633","Osen","0000",,"BØL",38,21,59
"1633","Osen","0000",,"KRFVO",124,72,196
"1633","Osen","0000",,"SET",43,23,66
"1634","Oppdal","0000",,"A",1218,383,1601
"1634","Oppdal","0000",,"SV",61,27,88
"1634","Oppdal","0000",,"SP",468,112,580
"1634","Oppdal","0000",,"KRF",159,54,213
"1634","Oppdal","0000",,"V",169,64,233
"1634","Oppdal","0000",,"H",283,125,408
"1634","Oppdal","0000",,"FRP",118,40,158
"1635","Rennebu","0000",,"A",318,71,389
"1635","Rennebu","0000",,"SP",295,46,341
"1635","Rennebu","0000",,"KRF",338,53,391
"1635","Rennebu","0000",,"H_V",172,19,191
"1636","Meldal","0000",,"A",725,293,1018
"1636","Meldal","0000",,"SP",748,99,847
"1636","Meldal","0000",,"KRF",54,24,78
"1636","Meldal","0000",,"V",61,10,71
"1636","Meldal","0000",,"H",73,17,90
"1636","Meldal","0000",,"FRP",67,14,81
"1636","Meldal","0000",,"DEMN",10,2,12
"1636","Meldal","0000",,"PP",66,9,75
"1638","Orkdal","0000",,"A",1097,258,1355
"1638","Orkdal","0000",,"SV",146,51,197
"1638","Orkdal","0000",,"SP",738,92,830
"1638","Orkdal","0000",,"KRF",195,45,240
"1638","Orkdal","0000",,"V",386,84,470
"1638","Orkdal","0000",,"H",222,66,288
"1638","Orkdal","0000",,"FRP",269,62,331
"1638","Orkdal","0000",,"DEMN",24,8,32
"1638","Orkdal","0000",,"OL",1096,203,1299
"1638","Orkdal","0000",,"SB",219,53,272
"1640","Røros","0000",,"A",1330,269,1599
"1640","Røros","0000",,"SV",244,42,286
"1640","Røros","0000",,"SP",221,36,257
"1640","Røros","0000",,"V",84,24,108
"1640","Røros","0000",,"H",417,98,515
"1640","Røros","0000",,"FRP",110,13,123
"1640","Røros","0000",,"RØL",151,42,193
"1644","Holtålen","0000",,"A",368,94,462
"1644","Holtålen","0000",,"SV",64,19,83
"1644","Holtålen","0000",,"H",190,53,243
"1644","Holtålen","0000",,"FLHOLT",395,63,458
"1648","Midtre Gauldal","0000",,"A",859,231,1090
"1648","Midtre Gauldal","0000",,"SV",43,10,53
"1648","Midtre Gauldal","0000",,"SP",399,55,454
"1648","Midtre Gauldal","0000",,"KRF",117,30,147
"1648","Midtre Gauldal","0000",,"V",78,12,90
"1648","Midtre Gauldal","0000",,"H",235,54,289
"1648","Midtre Gauldal","0000",,"FRP",194,39,233
"1648","Midtre Gauldal","0000",,"KYST",33,5,38
"1648","Midtre Gauldal","0000",,"BMG",459,87,546
"1653","Melhus","0000",,"A",2163,587,2750
"1653","Melhus","0000",,"SV",210,68,278
"1653","Melhus","0000",,"SP",1049,177,1226
"1653","Melhus","0000",,"KRF",374,115,489
"1653","Melhus","0000",,"V",161,49,210
"1653","Melhus","0000",,"H",1449,320,1769
"1653","Melhus","0000",,"FRP",586,133,719
"1657","Skaun","0000",,"A",704,134,838
"1657","Skaun","0000",,"SV",177,30,207
"1657","Skaun","0000",,"RØDT",28,12,40
"1657","Skaun","0000",,"SP",838,118,956
"1657","Skaun","0000",,"KRF",162,35,197
"1657","Skaun","0000",,"H",371,53,424
"1657","Skaun","0000",,"FRP",281,53,334
"1657","Skaun","0000",,"BLBU",311,41,352
"1662","Klæbu","0000",,"A",723,161,884
"1662","Klæbu","0000",,"SV",178,53,231
"1662","Klæbu","0000",,"SP",320,50,370
"1662","Klæbu","0000",,"V",241,40,281
"1662","Klæbu","0000",,"H",446,74,520
"1662","Klæbu","0000",,"FRP",291,52,343
"1663","Malvik","0000",,"A",1992,738,2730
"1663","Malvik","0000",,"SV",226,91,317
"1663","Malvik","0000",,"SP",262,67,329
"1663","Malvik","0000",,"KRF",119,45,164
"1663","Malvik","0000",,"V",301,97,398
"1663","Malvik","0000",,"H",1154,368,1522
"1663","Malvik","0000",,"FRP",434,152,586
"1663","Malvik","0000",,"MDG",99,36,135
"1664","Selbu","0000",,"H",231,42,273
"1664","Selbu","0000",,"FRP",171,37,208
"1664","Selbu","0000",,"APSV",818,145,963
"1664","Selbu","0000",,"SP_V_KRF",454,49,503
"1665","Tydal","0000",,"AP_SV_TY",123,54,177
"1665","Tydal","0000",,"LVS",191,49,240
"1665","Tydal","0000",,"TYDL",62,35,97
"1702","Steinkjer","0000",,"A",2962,973,3935
"1702","Steinkjer","0000",,"SV",289,121,410
"1702","Steinkjer","0000",,"SP",3116,524,3640
"1702","Steinkjer","0000",,"KRF",125,41,166
"1702","Steinkjer","0000",,"V",314,68,382
"1702","Steinkjer","0000",,"H",690,200,890
"1702","Steinkjer","0000",,"FRP",674,184,858
"1703","Namsos","0000",,"A",1848,422,2270
"1703","Namsos","0000",,"SV",869,196,1065
"1703","Namsos","0000",,"SP",267,62,329
"1703","Namsos","0000",,"KRF",209,51,260
"1703","Namsos","0000",,"V",388,61,449
"1703","Namsos","0000",,"H",740,150,890
"1703","Namsos","0000",,"FRP",468,89,557
"1711","Meråker","0000",,"A",328,110,438
"1711","Meråker","0000",,"SV",51,24,75
"1711","Meråker","0000",,"SP",140,18,158
"1711","Meråker","0000",,"V",170,40,210
"1711","Meråker","0000",,"H",95,23,118
"1711","Meråker","0000",,"FRP",39,12,51
"1711","Meråker","0000",,"METPBL",148,29,177
"1714","Stjørdal","0000",,"A",3812,739,4551
"1714","Stjørdal","0000",,"SV",360,79,439
"1714","Stjørdal","0000",,"RØDT",57,20,77
"1714","Stjørdal","0000",,"SP",1579,270,1849
"1714","Stjørdal","0000",,"KRF",325,85,410
"1714","Stjørdal","0000",,"V",378,97,475
"1714","Stjørdal","0000",,"H",1346,309,1655
"1714","Stjørdal","0000",,"FRP",696,157,853
"1714","Stjørdal","0000",,"MDG",120,42,162
"1717","Frosta","0000",,"A",229,33,262
"1717","Frosta","0000",,"SV",93,16,109
"1717","Frosta","0000",,"SP",261,23,284
"1717","Frosta","0000",,"KRF",67,12,79
"1717","Frosta","0000",,"V",131,8,139
"1717","Frosta","0000",,"H",361,60,421
"1718","Leksvik","0000",,"A",423,100,523
"1718","Leksvik","0000",,"SV",41,17,58
"1718","Leksvik","0000",,"SP",329,66,395
"1718","Leksvik","0000",,"KRF",83,27,110
"1718","Leksvik","0000",,"V",75,9,84
"1718","Leksvik","0000",,"H",292,49,341
"1718","Leksvik","0000",,"FRP",191,30,221
"1719","Levanger","0000",,"A",3074,904,3978
"1719","Levanger","0000",,"SV",377,186,563
"1719","Levanger","0000",,"SP",991,170,1161
"1719","Levanger","0000",,"KRF",461,147,608
"1719","Levanger","0000",,"V",446,128,574
"1719","Levanger","0000",,"H",962,307,1269
"1719","Levanger","0000",,"FRP",468,178,646
"1719","Levanger","0000",,"DEMN",13,2,15
"1719","Levanger","0000",,"MDG",46,16,62
"1721","Verdal","0000",,"A",2381,691,3072
"1721","Verdal","0000",,"SV",222,51,273
"1721","Verdal","0000",,"RØDT",60,22,82
"1721","Verdal","0000",,"SP",1020,184,1204
"1721","Verdal","0000",,"KRF",127,37,164
"1721","Verdal","0000",,"V",276,73,349
"1721","Verdal","0000",,"H",607,146,753
"1721","Verdal","0000",,"FRP",468,150,618
"1724","Verran","0000",,"A",352,87,439
"1724","Verran","0000",,"SP",318,41,359
"1724","Verran","0000",,"KRF",23,5,28
"1724","Verran","0000",,"V",241,33,274
"1724","Verran","0000",,"FRP",73,14,87
"1724","Verran","0000",,"BIV",27,14,41
"1725","Namdalseid","0000",,"A",214,46,260
"1725","Namdalseid","0000",,"SP",416,66,482
"1725","Namdalseid","0000",,"KRF",37,5,42
"1725","Namdalseid","0000",,"V",53,10,63
"1725","Namdalseid","0000",,"H",38,12,50
"1736","Snåsa","0000",,"A",396,82,478
"1736","Snåsa","0000",,"SV",45,12,57
"1736","Snåsa","0000",,"SP",349,73,422
"1736","Snåsa","0000",,"V",127,28,155
"1736","Snåsa","0000",,"H",48,15,63
"1736","Snåsa","0000",,"FRP",23,11,34
"1738","Lierne","0000",,"A",344,34,378
"1738","Lierne","0000",,"SP",133,23,156
"1738","Lierne","0000",,"KRF",22,8,30
"1738","Lierne","0000",,"V",28,1,29
"1738","Lierne","0000",,"LB",68,11,79
"1739","Røyrvik","0000",,"A",113,61,174
"1739","Røyrvik","0000",,"SBLRØ",101,47,148
"1740","Namsskogan","0000",,"A",150,48,198
"1740","Namsskogan","0000",,"SV",80,25,105
"1740","Namsskogan","0000",,"SP",39,9,48
"1740","Namsskogan","0000",,"FRP",24,6,30
"1740","Namsskogan","0000",,"OPTI",120,23,143
"1742","Grong","0000",,"A",414,89,503
"1742","Grong","0000",,"SV",83,22,105
"1742","Grong","0000",,"SP",445,86,531
"1742","Grong","0000",,"V",44,8,52
"1742","Grong","0000",,"H",87,25,112
"1743","Høylandet","0000",,"A",208,35,243
"1743","Høylandet","0000",,"SP",295,73,368
"1743","Høylandet","0000",,"V",26,7,33
"1743","Høylandet","0000",,"BYGH",32,5,37
"1743","Høylandet","0000",,"VØHK",35,9,44
"1744","Overhalla","0000",,"A",558,164,722
"1744","Overhalla","0000",,"SV",53,15,68
"1744","Overhalla","0000",,"SP",622,126,748
"1744","Overhalla","0000",,"V",45,18,63
"1744","Overhalla","0000",,"H",81,15,96
"1744","Overhalla","0000",,"FRP",193,41,234
"1748","Fosnes","0000",,"A",99,21,120
"1748","Fosnes","0000",,"FLSPKRF",166,40,206
"1749","Flatanger","0000",,"A",61,30,91
"1749","Flatanger","0000",,"SV",37,13,50
"1749","Flatanger","0000",,"SP",92,17,109
"1749","Flatanger","0000",,"KRF",15,7,22
"1749","Flatanger","0000",,"V",149,42,191
"1749","Flatanger","0000",,"H",48,17,65
"1749","Flatanger","0000",,"FRP",63,28,91
"1750","Vikna","0000",,"A",361,115,476
"1750","Vikna","0000",,"SV",43,16,59
"1750","Vikna","0000",,"SP",239,41,280
"1750","Vikna","0000",,"KRF",127,32,159
"1750","Vikna","0000",,"V",253,37,290
"1750","Vikna","0000",,"H",275,54,329
"1750","Vikna","0000",,"FRP",273,87,360
"1751","Nærøy","0000",,"A",491,97,588
"1751","Nærøy","0000",,"SV",159,40,199
"1751","Nærøy","0000",,"SP",663,116,779
"1751","Nærøy","0000",,"KRF",84,27,111
"1751","Nærøy","0000",,"V",107,18,125
"1751","Nærøy","0000",,"H",162,26,188
"1751","Nærøy","0000",,"FRP",188,53,241
"1755","Leka","0000",,"A",78,24,102
"1755","Leka","0000",,"SV",22,8,30
"1755","Leka","0000",,"SP",171,37,208
"1755","Leka","0000",,"V",23,7,30
"1756","Inderøy","0000",,"A",954,204,1158
"1756","Inderøy","0000",,"SV",151,48,199
"1756","Inderøy","0000",,"SP",1231,157,1388
"1756","Inderøy","0000",,"KRF",125,24,149
"1756","Inderøy","0000",,"V",68,17,85
"1756","Inderøy","0000",,"H",313,58,371
"1756","Inderøy","0000",,"FRP",100,36,136
"1804","Bodø","0000",,"A",4590,3476,8066
"1804","Bodø","0000",,"SV",524,431,955
"1804","Bodø","0000",,"RØDT",1071,453,1524
"1804","Bodø","0000",,"SP",458,223,681
"1804","Bodø","0000",,"KRF",486,280,766
"1804","Bodø","0000",,"V",458,310,768
"1804","Bodø","0000",,"H",3177,2352,5529
"1804","Bodø","0000",,"FRP",3114,2163,5277
"1804","Bodø","0000",,"KYST",47,23,70
"1804","Bodø","0000",,"MDG",86,86,172
"1805","Narvik","0000",,"A",2525,621,3146
"1805","Narvik","0000",,"SV",392,79,471
"1805","Narvik","0000",,"RØDT",410,87,497
"1805","Narvik","0000",,"SP",124,23,147
"1805","Narvik","0000",,"KRF",205,59,264
"1805","Narvik","0000",,"V",301,47,348
"1805","Narvik","0000",,"H",1839,299,2138
"1805","Narvik","0000",,"FRP",1541,337,1878
"1811","Bindal","0000",,"A",245,105,350
"1811","Bindal","0000",,"BAL",44,21,65
"1811","Bindal","0000",,"LHV",342,81,423
"1811","Bindal","0000",,"SP_SV",70,23,93
"1812","Sømna","0000",,"A",155,36,191
"1812","Sømna","0000",,"SP",345,60,405
"1812","Sømna","0000",,"KRF",43,14,57
"1812","Sømna","0000",,"FRP",55,7,62
"1812","Sømna","0000",,"SBL",47,4,51
"1812","Sømna","0000",,"TPLS",248,71,319
"1813","Brønnøy","0000",,"A",1084,218,1302
"1813","Brønnøy","0000",,"SV",82,35,117
"1813","Brønnøy","0000",,"SP",573,94,667
"1813","Brønnøy","0000",,"KRF",59,11,70
"1813","Brønnøy","0000",,"V",137,31,168
"1813","Brønnøy","0000",,"H",996,192,1188
"1813","Brønnøy","0000",,"FRP",118,31,149
"1815","Vega","0000",,"A",267,98,365
"1815","Vega","0000",,"SV",30,17,47
"1815","Vega","0000",,"SP",114,41,155
"1815","Vega","0000",,"H",41,17,58
"1815","Vega","0000",,"FRP",27,10,37
"1815","Vega","0000",,"KYST",44,7,51
"1816","Vevelstad","0000",,"A",36,27,63
"1816","Vevelstad","0000",,"KOM",23,23,46
"1816","Vevelstad","0000",,"SAMVE",120,47,167
"1818","Herøy","0000",,"A",327,101,428
"1818","Herøy","0000",,"FRP",109,29,138
"1818","Herøy","0000",,"HE_HVSP",190,29,219
"1820","Alstahaug","0000",,"A",836,259,1095
"1820","Alstahaug","0000",,"SV",52,21,73
"1820","Alstahaug","0000",,"RØDT",212,62,274
"1820","Alstahaug","0000",,"SP",299,67,366
"1820","Alstahaug","0000",,"KRF",52,22,74
"1820","Alstahaug","0000",,"V",233,97,330
"1820","Alstahaug","0000",,"H",523,188,711
"1820","Alstahaug","0000",,"FRP",324,114,438
"1822","Leirfjord","0000",,"A",289,116,405
"1822","Leirfjord","0000",,"SV",72,26,98
"1822","Leirfjord","0000",,"RØDT",31,16,47
"1822","Leirfjord","0000",,"SP",229,69,298
"1822","Leirfjord","0000",,"FRP",129,40,169
"1824","Vefsn","0000",,"A",1765,919,2684
"1824","Vefsn","0000",,"SV",125,89,214
"1824","Vefsn","0000",,"RØDT",365,203,568
"1824","Vefsn","0000",,"SP",342,102,444
"1824","Vefsn","0000",,"KRF",112,60,172
"1824","Vefsn","0000",,"V",224,114,338
"1824","Vefsn","0000",,"H",495,237,732
"1824","Vefsn","0000",,"FRP",651,320,971
"1825","Grane","0000",,"A",296,90,386
"1825","Grane","0000",,"SP",212,41,253
"1825","Grane","0000",,"FRP",53,26,79
"1826","Hattfjelldal","0000",,"A",253,71,324
"1826","Hattfjelldal","0000",,"SV",56,18,74
"1826","Hattfjelldal","0000",,"SP",282,64,346
"1827","Dønna","0000",,"A",185,60,245
"1827","Dønna","0000",,"SV",91,37,128
"1827","Dønna","0000",,"SP",79,16,95
"1827","Dønna","0000",,"H",83,28,111
"1827","Dønna","0000",,"FRP",55,14,69
"1827","Dønna","0000",,"KYST",81,19,100
"1828","Nesna","0000",,"A",172,66,238
"1828","Nesna","0000",,"SV",93,21,114
"1828","Nesna","0000",,"SP",112,31,143
"1828","Nesna","0000",,"V",37,11,48
"1828","Nesna","0000",,"H",204,58,262
"1828","Nesna","0000",,"FRP",64,27,91
"1832","Hemnes","0000",,"A",722,169,891
"1832","Hemnes","0000",,"SV",82,24,106
"1832","Hemnes","0000",,"SP",339,40,379
"1832","Hemnes","0000",,"KRF",60,8,68
"1832","Hemnes","0000",,"H",442,77,519
"1832","Hemnes","0000",,"FRP",403,54,457
"1832","Hemnes","0000",,"HEORD",61,34,95
"1833","Rana","0000",,"A",3103,1208,4311
"1833","Rana","0000",,"SV",513,195,708
"1833","Rana","0000",,"RØDT",246,103,349
"1833","Rana","0000",,"SP",692,163,855
"1833","Rana","0000",,"KRF",193,79,272
"1833","Rana","0000",,"V",342,118,460
"1833","Rana","0000",,"H",2610,676,3286
"1833","Rana","0000",,"FRP",950,269,1219
"1833","Rana","0000",,"MR",393,134,527
"1834","Lurøy","0000",,"A",390,88,478
"1834","Lurøy","0000",,"SP",112,15,127
"1834","Lurøy","0000",,"KRF",31,19,50
"1834","Lurøy","0000",,"V",24,11,35
"1834","Lurøy","0000",,"H",131,22,153
"1834","Lurøy","0000",,"FRP",48,12,60
"1834","Lurøy","0000",,"KYST",75,11,86
"1834","Lurøy","0000",,"LTV",88,12,100
"1835","Træna","0000",,"A",49,21,70
"1835","Træna","0000",,"SPKRF",131,37,168
"1836","Rødøy","0000",,"SP",175,67,242
"1836","Rødøy","0000",,"FRP",43,25,68
"1836","Rødøy","0000",,"KYST",137,56,193
"1836","Rødøy","0000",,"RFL",90,34,124
"1836","Rødøy","0000",,"STØKURS",45,24,69
"1837","Meløy","0000",,"A",595,239,834
"1837","Meløy","0000",,"SV",105,34,139
"1837","Meløy","0000",,"SP",289,47,336
"1837","Meløy","0000",,"KRF",152,64,216
"1837","Meløy","0000",,"V",136,28,164
"1837","Meløy","0000",,"H",823,201,1024
"1837","Meløy","0000",,"FRP",310,140,450
"1838","Gildeskål","0000",,"A",246,47,293
"1838","Gildeskål","0000",,"SV",53,16,69
"1838","Gildeskål","0000",,"SP",98,18,116
"1838","Gildeskål","0000",,"KRF",34,6,40
"1838","Gildeskål","0000",,"V",83,14,97
"1838","Gildeskål","0000",,"H",174,37,211
"1838","Gildeskål","0000",,"FRP",145,29,174
"1838","Gildeskål","0000",,"MDG",6,7,13
"1838","Gildeskål","0000",,"ARNØY",47,6,53
"1839","Beiarn","0000",,"A",277,60,337
"1839","Beiarn","0000",,"SP",156,43,199
"1839","Beiarn","0000",,"BEBL",123,44,167
"1840","Saltdal","0000",,"A",766,147,913
"1840","Saltdal","0000",,"SV",131,43,174
"1840","Saltdal","0000",,"SP",154,19,173
"1840","Saltdal","0000",,"KRF",91,18,109
"1840","Saltdal","0000",,"H",666,113,779
"1840","Saltdal","0000",,"FRP",257,35,292
"1841","Fauske","0000",,"A",1288,381,1669
"1841","Fauske","0000",,"SV",112,36,148
"1841","Fauske","0000",,"RØDT",164,37,201
"1841","Fauske","0000",,"SP",81,20,101
"1841","Fauske","0000",,"KRF",84,24,108
"1841","Fauske","0000",,"V",140,26,166
"1841","Fauske","0000",,"H",758,179,937
"1841","Fauske","0000",,"FRP",522,140,662
"1841","Fauske","0000",,"AFI",94,21,115
"1841","Fauske","0000",,"FLFA",659,100,759
"1845","Sørfold","0000",,"A",498,93,591
"1845","Sørfold","0000",,"SV",48,15,63
"1845","Sørfold","0000",,"SP",112,28,140
"1845","Sørfold","0000",,"H",120,22,142
"1845","Sørfold","0000",,"FRP",75,12,87
"1848","Steigen","0000",,"A",223,88,311
"1848","Steigen","0000",,"SV",39,17,56
"1848","Steigen","0000",,"RØDT",42,25,67
"1848","Steigen","0000",,"SP",185,81,266
"1848","Steigen","0000",,"KRF",36,26,62
"1848","Steigen","0000",,"V",187,53,240
"1848","Steigen","0000",,"H",65,31,96
"1848","Steigen","0000",,"FRP",83,38,121
"1848","Steigen","0000",,"PP",126,42,168
"1849","Hamarøy","0000",,"A",232,90,322
"1849","Hamarøy","0000",,"SV",35,10,45
"1849","Hamarøy","0000",,"SP",103,28,131
"1849","Hamarøy","0000",,"V",175,37,212
"1849","Hamarøy","0000",,"H",163,35,198
"1850","Tysfjord","0000",,"A",298,176,474
"1850","Tysfjord","0000",,"SV",36,22,58
"1850","Tysfjord","0000",,"SP",67,37,104
"1850","Tysfjord","0000",,"HKVU",213,130,343
"1850","Tysfjord","0000",,"TPLTY",135,46,181
"1850","Tysfjord","0000",,"TYSBYG",57,41,98
"1851","Lødingen","0000",,"A",180,75,255
"1851","Lødingen","0000",,"SV",79,31,110
"1851","Lødingen","0000",,"SP",40,12,52
"1851","Lødingen","0000",,"V",93,38,131
"1851","Lødingen","0000",,"H",256,95,351
"1851","Lødingen","0000",,"FRP",212,100,312
"1852","Tjeldsund","0000",,"A",141,31,172
"1852","Tjeldsund","0000",,"SP",27,3,30
"1852","Tjeldsund","0000",,"H",262,43,305
"1852","Tjeldsund","0000",,"FRP",56,9,65
"1852","Tjeldsund","0000",,"BFKH",32,0,32
"1852","Tjeldsund","0000",,"HTL",89,31,120
"1853","Evenes","0000",,"A",141,35,176
"1853","Evenes","0000",,"SV",27,6,33
"1853","Evenes","0000",,"SP",63,12,75
"1853","Evenes","0000",,"H",348,60,408
"1853","Evenes","0000",,"FRP",41,5,46
"1854","Ballangen","0000",,"A",210,64,274
"1854","Ballangen","0000",,"SP",253,66,319
"1854","Ballangen","0000",,"KRF",47,13,60
"1854","Ballangen","0000",,"V",9,5,14
"1854","Ballangen","0000",,"H",403,99,502
"1854","Ballangen","0000",,"FRP",104,39,143
"1856","Røst","0000",,"APRU",129,41,170
"1856","Røst","0000",,"SENTRUM",96,35,131
"1857","Værøy","0000",,"A",60,21,81
"1857","Værøy","0000",,"KRF",35,15,50
"1857","Værøy","0000",,"FV",146,61,207
"1859","Flakstad","0000",,"A",68,14,82
"1859","Flakstad","0000",,"SP",137,28,165
"1859","Flakstad","0000",,"FRP",41,10,51
"1859","Flakstad","0000",,"MDG",23,5,28
"1859","Flakstad","0000",,"FDL",198,29,227
"1859","Flakstad","0000",,"FKBL",72,19,91
"1860","Vestvågøy","0000",,"A",1005,394,1399
"1860","Vestvågøy","0000",,"SV",180,82,262
"1860","Vestvågøy","0000",,"SP",459,129,588
"1860","Vestvågøy","0000",,"KRF",297,116,413
"1860","Vestvågøy","0000",,"V",93,32,125
"1860","Vestvågøy","0000",,"H",1064,332,1396
"1860","Vestvågøy","0000",,"FRP",367,153,520
"1860","Vestvågøy","0000",,"MDG",60,34,94
"1865","Vågan","0000",,"A",981,353,1334
"1865","Vågan","0000",,"SV",122,50,172
"1865","Vågan","0000",,"RØDT",196,73,269
"1865","Vågan","0000",,"SP",282,37,319
"1865","Vågan","0000",,"KRF",45,25,70
"1865","Vågan","0000",,"V",173,43,216
"1865","Vågan","0000",,"H",959,290,1249
"1865","Vågan","0000",,"FRP",231,131,362
"1865","Vågan","0000",,"KYST",32,18,50
"1866","Hadsel","0000",,"A",561,128,689
"1866","Hadsel","0000",,"SV",111,32,143
"1866","Hadsel","0000",,"RØDT",72,26,98
"1866","Hadsel","0000",,"SP",177,31,208
"1866","Hadsel","0000",,"KRF",77,31,108
"1866","Hadsel","0000",,"V",145,49,194
"1866","Hadsel","0000",,"H",299,77,376
"1866","Hadsel","0000",,"FRP",1102,269,1371
"1866","Hadsel","0000",,"HADSELFL",372,100,472
"1866","Hadsel","0000",,"MOS",186,31,217
"1867","Bø","0000",,"SV",57,16,73
"1867","Bø","0000",,"SP",139,50,189
"1867","Bø","0000",,"V",119,44,163
"1867","Bø","0000",,"FRP",79,39,118
"1867","Bø","0000",,"BØHAP",716,238,954
"1868","Øksnes","0000",,"A",481,157,638
"1868","Øksnes","0000",,"SV",93,38,131
"1868","Øksnes","0000",,"SP",93,32,125
"1868","Øksnes","0000",,"KRF",105,32,137
"1868","Øksnes","0000",,"H",234,62,296
"1868","Øksnes","0000",,"FRP",125,41,166
"1868","Øksnes","0000",,"ØTL",365,100,465
"1870","Sortland","0000",,"A",1014,333,1347
"1870","Sortland","0000",,"SV",167,50,217
"1870","Sortland","0000",,"RØDT",241,57,298
"1870","Sortland","0000",,"SP",196,36,232
"1870","Sortland","0000",,"KRF",69,27,96
"1870","Sortland","0000",,"V",70,22,92
"1870","Sortland","0000",,"H",1349,313,1662
"1870","Sortland","0000",,"FRP",439,187,626
"1871","Andøy","0000",,"A",394,105,499
"1871","Andøy","0000",,"SP",196,29,225
"1871","Andøy","0000",,"KRF",67,26,93
"1871","Andøy","0000",,"V",114,23,137
"1871","Andøy","0000",,"H",813,140,953
"1871","Andøy","0000",,"FRP",190,36,226
"1871","Andøy","0000",,"AND",315,55,370
"1874","Moskenes","0000",,"A",42,11,53
"1874","Moskenes","0000",,"SV",49,26,75
"1874","Moskenes","0000",,"MKBYGD",92,23,115
"1874","Moskenes","0000",,"MOSKFL",161,54,215
"1901","Harstad","0000",,"A",2583,807,3390
"1901","Harstad","0000",,"SV",230,70,300
"1901","Harstad","0000",,"RØDT",286,95,381
"1901","Harstad","0000",,"SP",722,125,847
"1901","Harstad","0000",,"KRF",347,89,436
"1901","Harstad","0000",,"V",517,119,636
"1901","Harstad","0000",,"H",1366,318,1684
"1901","Harstad","0000",,"FRP",3197,779,3976
"1901","Harstad","0000",,"KYST",49,12,61
"1902","Tromsø","0000",,"A",6567,2343,8910
"1902","Tromsø","0000",,"SV",1369,560,1929
"1902","Tromsø","0000",,"RØDT",1840,577,2417
"1902","Tromsø","0000",,"SP",657,157,814
"1902","Tromsø","0000",,"KRF",829,213,1042
"1902","Tromsø","0000",,"V",967,324,1291
"1902","Tromsø","0000",,"H",9587,2584,12171
"1902","Tromsø","0000",,"FRP",3289,1092,4381
"1902","Tromsø","0000",,"KYST",132,37,169
"1902","Tromsø","0000",,"MDG",454,141,595
"1902","Tromsø","0000",,"NKP",33,10,43
"1911","Kvæfjord","0000",,"A",411,93,504
"1911","Kvæfjord","0000",,"SV",92,39,131
"1911","Kvæfjord","0000",,"SP",164,26,190
"1911","Kvæfjord","0000",,"V",179,30,209
"1911","Kvæfjord","0000",,"H",171,37,208
"1911","Kvæfjord","0000",,"FRP",184,41,225
"1913","Skånland","0000",,"A",499,105,604
"1913","Skånland","0000",,"SV",46,9,55
"1913","Skånland","0000",,"RØDT",51,22,73
"1913","Skånland","0000",,"V",179,28,207
"1913","Skånland","0000",,"H",433,77,510
"1915","Bjarkøy","0000",,"SP",80,46,126
"1915","Bjarkøy","0000",,"BJAFL",42,23,65
"1915","Bjarkøy","0000",,"SFSBL",68,24,92
"1917","Ibestad","0000",,"A",111,30,141
"1917","Ibestad","0000",,"SP",121,47,168
"1917","Ibestad","0000",,"V",44,7,51
"1917","Ibestad","0000",,"H",120,51,171
"1917","Ibestad","0000",,"ANFL",263,39,302
"1919","Gratangen","0000",,"A",146,72,218
"1919","Gratangen","0000",,"SV",23,12,35
"1919","Gratangen","0000",,"SP",272,67,339
"1919","Gratangen","0000",,"FRP",16,9,25
"1920","Lavangen","0000",,"A",199,35,234
"1920","Lavangen","0000",,"SP",134,33,167
"1920","Lavangen","0000",,"H",96,19,115
"1920","Lavangen","0000",,"FRP",74,31,105
"1922","Bardu","0000",,"A",803,182,985
"1922","Bardu","0000",,"SV",44,5,49
"1922","Bardu","0000",,"SP",221,41,262
"1922","Bardu","0000",,"V",62,12,74
"1922","Bardu","0000",,"H",420,103,523
"1922","Bardu","0000",,"FRP",61,26,87
"1923","Salangen","0000",,"A",328,100,428
"1923","Salangen","0000",,"SV",29,17,46
"1923","Salangen","0000",,"SP",404,93,497
"1923","Salangen","0000",,"H",97,26,123
"1924","Målselv","0000",,"A",1039,168,1207
"1924","Målselv","0000",,"SV",71,13,84
"1924","Målselv","0000",,"SP",329,23,352
"1924","Målselv","0000",,"V",326,34,360
"1924","Målselv","0000",,"H",501,88,589
"1924","Målselv","0000",,"FRP",258,57,315
"1925","Sørreisa","0000",,"A",354,100,454
"1925","Sørreisa","0000",,"SV",49,14,63
"1925","Sørreisa","0000",,"SP",87,20,107
"1925","Sørreisa","0000",,"KRF",72,20,92
"1925","Sørreisa","0000",,"H",194,43,237
"1925","Sørreisa","0000",,"FRP",115,26,141
"1925","Sørreisa","0000",,"SAMLIST",421,92,513
"1926","Dyrøy","0000",,"A",221,62,283
"1926","Dyrøy","0000",,"SV",42,8,50
"1926","Dyrøy","0000",,"SP",120,29,149
"1926","Dyrøy","0000",,"H",52,15,67
"1926","Dyrøy","0000",,"FD",86,24,110
"1927","Tranøy","0000",,"A",212,73,285
"1927","Tranøy","0000",,"SV",30,17,47
"1927","Tranøy","0000",,"SP",64,18,82
"1927","Tranøy","0000",,"V",54,8,62
"1927","Tranøy","0000",,"H",100,25,125
"1927","Tranøy","0000",,"FRP",40,15,55
"1927","Tranøy","0000",,"NKP",12,4,16
"1927","Tranøy","0000",,"TFL",146,29,175
"1928","Torsken","0000",,"A",179,67,246
"1928","Torsken","0000",,"SP",107,38,145
"1928","Torsken","0000",,"KYST",102,21,123
"1929","Berg","0000",,"A",175,30,205
"1929","Berg","0000",,"FRP",17,18,35
"1929","Berg","0000",,"BFE",78,23,101
"1929","Berg","0000",,"BSAM",127,78,205
"1931","Lenvik","0000",,"A",789,274,1063
"1931","Lenvik","0000",,"SV",143,74,217
"1931","Lenvik","0000",,"SP",360,57,417
"1931","Lenvik","0000",,"KRF",146,82,228
"1931","Lenvik","0000",,"V",139,49,188
"1931","Lenvik","0000",,"H",983,302,1285
"1931","Lenvik","0000",,"FRP",719,266,985
"1931","Lenvik","0000",,"KYST",54,13,67
"1931","Lenvik","0000",,"LENVIK",463,117,580
"1933","Balsfjord","0000",,"A",1074,146,1220
"1933","Balsfjord","0000",,"SV",79,16,95
"1933","Balsfjord","0000",,"SP",244,26,270
"1933","Balsfjord","0000",,"KRF",103,25,128
"1933","Balsfjord","0000",,"V",41,8,49
"1933","Balsfjord","0000",,"H",544,86,630
"1933","Balsfjord","0000",,"FRP",307,54,361
"1936","Karlsøy","0000",,"A",313,75,388
"1936","Karlsøy","0000",,"SV",39,18,57
"1936","Karlsøy","0000",,"SP",105,17,122
"1936","Karlsøy","0000",,"H",38,11,49
"1936","Karlsøy","0000",,"FRP",207,55,262
"1936","Karlsøy","0000",,"KYST",99,17,116
"1936","Karlsøy","0000",,"FLRRR",127,22,149
"1938","Lyngen","0000",,"A",565,118,683
"1938","Lyngen","0000",,"SP",103,16,119
"1938","Lyngen","0000",,"KRF",101,19,120
"1938","Lyngen","0000",,"V",34,11,45
"1938","Lyngen","0000",,"H",202,46,248
"1938","Lyngen","0000",,"FRP",146,55,201
"1938","Lyngen","0000",,"KYST",37,6,43
"1938","Lyngen","0000",,"KRSL",74,5,79
"1939","Storfjord","0000",,"A",399,73,472
"1939","Storfjord","0000",,"SP",157,23,180
"1939","Storfjord","0000",,"H",140,21,161
"1939","Storfjord","0000",,"FRP",82,13,95
"1939","Storfjord","0000",,"FJORD",95,3,98
"1940","Gaivuona suohkan / Kåfjord","0000",,"A",452,79,531
"1940","Gaivuona suohkan / Kåfjord","0000",,"SP",122,16,138
"1940","Gaivuona suohkan / Kåfjord","0000",,"KRF",193,12,205
"1940","Gaivuona suohkan / Kåfjord","0000",,"FRP",85,12,97
"1940","Gaivuona suohkan / Kåfjord","0000",,"KYST",65,2,67
"1940","Gaivuona suohkan / Kåfjord","0000",,"MDG",29,4,33
"1940","Gaivuona suohkan / Kåfjord","0000",,"KBYG",58,5,63
"1941","Skjervøy","0000",,"A",193,48,241
"1941","Skjervøy","0000",,"SV",138,31,169
"1941","Skjervøy","0000",,"SP",141,21,162
"1941","Skjervøy","0000",,"KRF",63,8,71
"1941","Skjervøy","0000",,"H",149,32,181
"1941","Skjervøy","0000",,"FRP",94,18,112
"1941","Skjervøy","0000",,"KYST",390,120,510
"1942","Nordreisa","0000",,"A",737,218,955
"1942","Nordreisa","0000",,"SV",120,40,160
"1942","Nordreisa","0000",,"SP",189,38,227
"1942","Nordreisa","0000",,"KRF",188,36,224
"1942","Nordreisa","0000",,"V",28,8,36
"1942","Nordreisa","0000",,"H",318,55,373
"1942","Nordreisa","0000",,"FRP",334,142,476
"1943","Kvænangen","0000",,"A",85,47,132
"1943","Kvænangen","0000",,"SV",35,15,50
"1943","Kvænangen","0000",,"H",143,75,218
"1943","Kvænangen","0000",,"FRP",24,11,35
"1943","Kvænangen","0000",,"KYST",147,55,202
"1943","Kvænangen","0000",,"KIU",14,3,17
"2002","Vardø","0000",,"A",371,99,470
"2002","Vardø","0000",,"SV",71,10,81
"2002","Vardø","0000",,"V",90,16,106
"2002","Vardø","0000",,"H",73,12,85
"2002","Vardø","0000",,"FRP",194,48,242
"2002","Vardø","0000",,"KYST",76,15,91
"2003","Vadsø","0000",,"A",894,287,1181
"2003","Vadsø","0000",,"SV",274,75,349
"2003","Vadsø","0000",,"KRF",144,35,179
"2003","Vadsø","0000",,"V",155,38,193
"2003","Vadsø","0000",,"H",695,147,842
"2003","Vadsø","0000",,"FRP",101,45,146
"2004","Hammerfest","0000",,"A",1693,1113,2806
"2004","Hammerfest","0000",,"SV",143,127,270
"2004","Hammerfest","0000",,"SP",26,27,53
"2004","Hammerfest","0000",,"KRF",52,47,99
"2004","Hammerfest","0000",,"H",412,300,712
"2004","Hammerfest","0000",,"FRP",98,118,216
"2004","Hammerfest","0000",,"KYST",109,43,152
"2011","Guovdageainnu suohkan / Kautokeino","0000",,"A",74,48,122
"2011","Guovdageainnu suohkan / Kautokeino","0000",,"SP",32,12,44
"2011","Guovdageainnu suohkan / Kautokeino","0000",,"V",123,51,174
"2011","Guovdageainnu suohkan / Kautokeino","0000",,"H",64,53,117
"2011","Guovdageainnu suohkan / Kautokeino","0000",,"FRP",38,16,54
"2011","Guovdageainnu suohkan / Kautokeino","0000",,"SAME",288,124,412
"2011","Guovdageainnu suohkan / Kautokeino","0000",,"GDL",148,67,215
"2011","Guovdageainnu suohkan / Kautokeino","0000",,"JL",212,184,396
"2012","Alta","0000",,"A",1549,868,2417
"2012","Alta","0000",,"SV",418,213,631
"2012","Alta","0000",,"SP",105,44,149
"2012","Alta","0000",,"KRF",212,130,342
"2012","Alta","0000",,"V",426,201,627
"2012","Alta","0000",,"H",1508,739,2247
"2012","Alta","0000",,"FRP",603,357,960
"2012","Alta","0000",,"KYST",560,288,848
"2012","Alta","0000",,"SAME",83,37,120
"2014","Loppa","0000",,"A",134,25,159
"2014","Loppa","0000",,"SV",41,12,53
"2014","Loppa","0000",,"SP",42,4,46
"2014","Loppa","0000",,"H",80,26,106
"2014","Loppa","0000",,"KYST",182,68,250
"2015","Hasvik","0000",,"A",210,78,288
"2015","Hasvik","0000",,"SP",97,32,129
"2015","Hasvik","0000",,"H",84,23,107
"2017","Kvalsund","0000",,"A",253,72,325
"2017","Kvalsund","0000",,"SV",68,24,92
"2017","Kvalsund","0000",,"H",56,12,68
"2018","Måsøy","0000",,"A",168,88,256
"2018","Måsøy","0000",,"SP",110,50,160
"2018","Måsøy","0000",,"H",146,59,205
"2019","Nordkapp","0000",,"A",462,156,618
"2019","Nordkapp","0000",,"SV",259,87,346
"2019","Nordkapp","0000",,"SP",27,8,35
"2019","Nordkapp","0000",,"V",28,14,42
"2019","Nordkapp","0000",,"H",235,81,316
"2019","Nordkapp","0000",,"FRP",63,39,102
"2020","Porsanger","0000",,"A",585,178,763
"2020","Porsanger","0000",,"SV",68,22,90
"2020","Porsanger","0000",,"SP",85,12,97
"2020","Porsanger","0000",,"H",568,147,715
"2020","Porsanger","0000",,"FRP",206,52,258
"2021","Karasjoga gielda / Karasjok","0000",,"A",202,97,299
"2021","Karasjoga gielda / Karasjok","0000",,"SP",266,69,335
"2021","Karasjoga gielda / Karasjok","0000",,"KRF",32,8,40
"2021","Karasjoga gielda / Karasjok","0000",,"V",89,19,108
"2021","Karasjoga gielda / Karasjok","0000",,"H",31,20,51
"2021","Karasjoga gielda / Karasjok","0000",,"SAME",132,46,178
"2021","Karasjoga gielda / Karasjok","0000",,"ARJA",89,15,104
"2021","Karasjoga gielda / Karasjok","0000",,"KARLIS",169,52,221
"2021","Karasjoga gielda / Karasjok","0000",,"KJS",49,36,85
"2022","Lebesby","0000",,"A",264,78,342
"2022","Lebesby","0000",,"BFLEB",184,24,208
"2023","Gamvik","0000",,"A",143,39,182
"2023","Gamvik","0000",,"SV",112,30,142
"2023","Gamvik","0000",,"H",77,19,96
"2023","Gamvik","0000",,"FRP",36,8,44
"2023","Gamvik","0000",,"TLG",51,16,67
"2024","Berlevåg","0000",,"A",168,51,219
"2024","Berlevåg","0000",,"H",245,64,309
"2024","Berlevåg","0000",,"FRP",31,12,43
"2025","Deanu gielda / Tana","0000",,"A",440,141,581
"2025","Deanu gielda / Tana","0000",,"SV",43,12,55
"2025","Deanu gielda / Tana","0000",,"SP",145,45,190
"2025","Deanu gielda / Tana","0000",,"V",68,9,77
"2025","Deanu gielda / Tana","0000",,"H",268,39,307
"2025","Deanu gielda / Tana","0000",,"FRP",63,15,78
"2025","Deanu gielda / Tana","0000",,"FLOKT",100,14,114
"2025","Deanu gielda / Tana","0000",,"SFP_NSR",60,29,89
"2027","Unjargga gielda / Nesseby","0000",,"A",108,103,211
"2027","Unjargga gielda / Nesseby","0000",,"SV",29,23,52
"2027","Unjargga gielda / Nesseby","0000",,"H",59,24,83
"2027","Unjargga gielda / Nesseby","0000",,"FRP",37,42,79
"2027","Unjargga gielda / Nesseby","0000",,"SAME",54,12,66
"2027","Unjargga gielda / Nesseby","0000",,"TLNE",22,22,44
"2028","Båtsfjord","0000",,"A",383,123,506
"2028","Båtsfjord","0000",,"H",348,86,434
"2028","Båtsfjord","0000",,"FRP",18,18,36
"2028","Båtsfjord","0000",,"BÅTL",31,21,52
"2030","Sør-Varanger","0000",,"A",1215,498,1713
"2030","Sør-Varanger","0000",,"SV",231,144,375
"2030","Sør-Varanger","0000",,"SP",606,141,747
"2030","Sør-Varanger","0000",,"KRF",66,26,92
"2030","Sør-Varanger","0000",,"V",119,32,151
"2030","Sør-Varanger","0000",,"H",678,235,913
"2030","Sør-Varanger","0000",,"FRP",213,107,320
"2030","Sør-Varanger","0000",,"MVL",68,24,92
"2030","Sør-Varanger","0000",,"SVS",48,26,74
